process_imu_attitude_calculation	process_imu_attitude_calculation.c
float_add_64bit	float_add_64bit.c
float_add_64bit_alt	float_add_64bit_alt.c
int_to_float_64bit	int_to_float_64bit.c
int_to_float_64bit_signed	int_to_float_64bit_signed.c
float_divide_64bit_complex	float_divide_64bit_complex.c
float_divide_64bit	float_divide_64bit.c
float_multiply_64bit_alt	float_multiply_64bit_alt.c
float_handle_special_cases	float_handle_special_cases.c
float_multiply_64bit	float_multiply_64bit.c
float_compare_special_cases	float_compare_special_cases.c
float_compare_values	float_compare_values.c
float_swap_parameters	float_swap_parameters.c
call_float_compare	call_float_compare.c
float_compare_boolean	float_compare_boolean.c
float_compare_boolean_inverted	float_compare_boolean_inverted.c
float_compare_boolean_or	float_compare_boolean_or.c
float_compare_boolean_or_swapped	float_compare_boolean_or_swapped.c
float_compare_boolean_inverted_swapped	float_compare_boolean_inverted_swapped.c
check_float_nan	check_float_nan.c
float_to_int	float_to_int.c
float_to_int_conversion	float_to_int_conversion.c
complex_float_conversion	complex_float_conversion.c
complex_float_math_conversion	complex_float_math_conversion.c
handle_signed_division	handle_signed_division.c
handle_unsigned_division	handle_unsigned_division.c
calculate_mathematical_formula	calculate_mathematical_formula.c
process_imu_sensor_data_wrapper	process_imu_sensor_data_wrapper.c
process_imu_attitude_data	process_imu_attitude_data.c
interpolate_imu_data	interpolate_imu_data.c
process_imu_sensor_data	process_imu_sensor_data.c
validate_float_value	validate_float_value.c
find_minimum_float_value	find_minimum_float_value.c
find_maximum_float_value	find_maximum_float_value.c
process_array_indices	process_array_indices.c
validate_string_length	validate_string_length.c
interpolate_2d_coordinates	interpolate_2d_coordinates.c
interpolate_1d_value	interpolate_1d_value.c
calculate_signed_math_result	calculate_signed_math_result.c
perform_complex_division	perform_complex_division.c
compare_byte_arrays	compare_byte_arrays.c
calculate_string_length	calculate_string_length.c
spec_ble_command_hook	spec_ble_command_hook.c
handle_process_state_machine	handle_process_state_machine.c
handle_attitude_trigger	handle_attitude_trigger.c
calculate_brightness_level	calculate_brightness_level.c
opt3007_get_max_lux	opt3007_get_max_lux.c
fuel_gauge_update	fuel_gauge_update.c
collect_system_status_info	collect_system_status_info.c
format_string_with_printf	format_string_with_printf.c
initialize_system_device	initialize_system_device.c
calculate_mathematical_result	calculate_mathematical_result.c
calculate_mathematical_result_alt	calculate_mathematical_result_alt.c
parse_json_value	parse_json_value.c
create_json_number_value	create_json_number_value.c
validate_and_process_data	validate_and_process_data.c
calculate_exponential_function	calculate_exponential_function.c
calculate_complex_mathematical_function_comprehensive	calculate_complex_mathematical_function_comprehensive.c
get_system_parameter	get_system_parameter.c
calculate_complex_math_result	calculate_complex_math_result.c
format_float_to_string	format_float_to_string.c
switch_to_dfu_mode	switch_to_dfu_mode.c
local_esbs_ipc_service_recv	local_esbs_ipc_service_recv.c
power_for_panel	power_for_panel.c
power_for_imu_and_mic	power_for_imu_and_mic.c
power_down_panel	power_down_panel.c
power_down_imu_and_mic	power_down_imu_and_mic.c
configure_device_parameters	configure_device_parameters.c
runtime_info_sync	runtime_info_sync.c
get_system_flag	get_system_flag.c
get_work_mode	get_work_mode.c
get_data_byte_99	get_data_byte_99.c
set_system_navigation_mode	set_system_navigation_mode.c
initialize_config_signature	initialize_config_signature.c
check_system_status	check_system_status.c
load_work_mode_settings	load_work_mode_settings.c
copy_system_data	copy_system_data.c
set_system_byte_69	set_system_byte_69.c
reset_all_static_info	reset_all_static_info.c
get_work_mode	get_work_mode.c
check_driver_and_execute	check_driver_and_execute.c
power_down_and_execute	power_down_and_execute.c
handle_system_flags_and_work_mode	handle_system_flags_and_work_mode.c
get_system_byte_1	get_system_byte_1.c
change_work_mode_to	change_work_mode_to.c
_1b85815	_1b85815.c
handle_event_processing	handle_event_processing.c
handle_conditional_event	handle_conditional_event.c
handle_validated_event	handle_validated_event.c
handle_bit_pattern_event	handle_bit_pattern_event.c
handle_specific_events	handle_specific_events.c
handle_state_validated_event	handle_state_validated_event.c
call_conditional_event_handler	call_conditional_event_handler.c
call_conditional_event_handler_inverted	call_conditional_event_handler_inverted.c
button_init	button_init.c
call_validated_event_handler_9	call_validated_event_handler_9.c
bt_send_enabled	bt_send_enabled.c
handle_ancs_operation	handle_ancs_operation.c
handle_message_enqueue	handle_message_enqueue.c
bt_receive_cb	bt_receive_cb.c
handle_message_dequeue	handle_message_dequeue.c
copy_data_structure	copy_data_structure.c
get_bluetooth_manager	get_bluetooth_manager.c
initialize_data_structure	initialize_data_structure.c
handle_parameter_operation	handle_parameter_operation.c
handle_parameter_validation	handle_parameter_validation.c
format_status_message	format_status_message.c
process_status_message	process_status_message.c
check_bonded_addr	check_bonded_addr.c
pairing_failed	pairing_failed.c
auth_cancel	auth_cancel.c
ancs_security_changed	ancs_security_changed.c
ancs_connected	ancs_connected.c
handle_status_update	handle_status_update.c
handle_conditional_operation	handle_conditional_operation.c
call_conditional_operation_zero	call_conditional_operation_zero.c
call_conditional_operation_one	call_conditional_operation_one.c
handle_multi_step_operation	handle_multi_step_operation.c
call_conditional_operation_one_alt	call_conditional_operation_one_alt.c
handle_validation_operation	handle_validation_operation.c
call_conditional_operation_zero_alt	call_conditional_operation_zero_alt.c
indicate_sc_cb	indicate_sc_cb.c
clear_system_flags	clear_system_flags.c
ancs_disconnected	ancs_disconnected.c
init_msgq_ancs	init_msgq_ancs.c
enqueue_ancs	enqueue_ancs.c
bt_ancs_data_source_handler	bt_ancs_data_source_handler.c
dequeue_ancs	dequeue_ancs.c
init_msgq_uid	init_msgq_uid.c
enqueue_uid_drop_package_	enqueue_uid_drop_package_.c
dequeue_uid	dequeue_uid.c
ancs_c_init	ancs_c_init.c
call_function_with_data	call_function_with_data.c
request_ancs_attr_ext	request_ancs_attr_ext.c
bt_start	bt_start.c
process_ancs_data	process_ancs_data.c
ble_ancs_data_req_thread	ble_ancs_data_req_thread.c
start_ancs_work_thread	start_ancs_work_thread.c
ancs_main	ancs_main.c
handle_state_management	handle_state_management.c
get_ancs_connection_handle	get_ancs_connection_handle.c
configure_work_mode_state	configure_work_mode_state.c
unlock_navigation_data_mutex	unlock_navigation_data_mutex.c
spi_master_transaction_debug	spi_master_transaction_debug.c
debug_init	debug_init.c
handle_message_enqueue_alt	handle_message_enqueue_alt.c
handle_message_dequeue_alt	handle_message_dequeue_alt.c
handle_heartbeat	handle_heartbeat.c
handle_data_processing	handle_data_processing.c
handle_complex_data_processing	handle_complex_data_processing.c
send_dmic_msg	send_dmic_msg.c
ble_process_get_req	ble_process_get_req.c
ble_process_put_req	ble_process_put_req.c
handle_command_data_processing	handle_command_data_processing.c
ble_process_post_req	ble_process_post_req.c
subcontracing_send_data_pkcs7	subcontracing_send_data_pkcs7.c
ncs_notification	ncs_notification.c
simulator_ancs_calendar_schedule_trigger	simulator_ancs_calendar_schedule_trigger.c
process_ble_command	process_ble_command.c
ble_work_thread	ble_work_thread.c
initialize_system_service	initialize_system_service.c
local_store_write	local_store_write.c
sett_handler	sett_handler.c
sett_init	sett_init.c
flash_settings_read	flash_settings_read.c
handle_data_verification	handle_data_verification.c
handle_chunked_data_verification	handle_chunked_data_verification.c
handle_retry_data_verification	handle_retry_data_verification.c
calc_flash_crc	calc_flash_crc.c
prepare_system_settings_for_verification	prepare_system_settings_for_verification.c
load_sys_setting	load_sys_setting.c
reset_usr_setting	reset_usr_setting.c
load_usr_setting	load_usr_setting.c
update_burial_point_to_flash	update_burial_point_to_flash.c
verify_user_data_reset_operation	verify_user_data_reset_operation.c
load_burial_point	load_burial_point.c
reset_all_usr_data	reset_all_usr_data.c
handle_data_writing	handle_data_writing.c
get_system_data	get_system_data.c
get_system_data_alt	get_system_data_alt.c
call_function_with_parameters	call_function_with_parameters.c
call_function_with_parameters_alt	call_function_with_parameters_alt.c
read_sys_settting_from_flash	read_sys_settting_from_flash.c
read_usr_settting_from_flash	read_usr_settting_from_flash.c
flash_ops_thread	flash_ops_thread.c
handle_operation_with_error_check	handle_operation_with_error_check.c
enqueue_file	enqueue_file.c
handle_message_dequeue_alt2	handle_message_dequeue_alt2.c
generate_lookup_table	generate_lookup_table.c
calculate_crc32	calculate_crc32.c
try_to_save_file	try_to_save_file.c
storage_commit_thread	storage_commit_thread.c
initialize_main_dispatch_task_scheduler	initialize_main_dispatch_task_scheduler.c
process_component_init_messages	process_component_init_messages.c
upgradeAppLanguageInfoToFlash	upgradeAppLanguageInfoToFlash.c
cleanAppLanguageInfo	cleanAppLanguageInfo.c
upgradeDashboardStartupModeInfoToFlash	upgradeDashboardStartupModeInfoToFlash.c
cleanDashBoardStartUpModeInfo	cleanDashBoardStartUpModeInfo.c
getAppLanguageInfofromFlash	getAppLanguageInfofromFlash.c
getDashboardStartUpModeInfofromFlash	getDashboardStartUpModeInfofromFlash.c
get_system_byte_1_alt	get_system_byte_1_alt.c
get_system_byte_2	get_system_byte_2.c
get_system_data_24	get_system_data_24.c
SettingStoreHandler	SettingStoreHandler.c
handle_message_processing	handle_message_processing.c
upgradeQuickNoteDataToFlash	upgradeQuickNoteDataToFlash.c
deleteQuickNoteData	deleteQuickNoteData.c
getQuickNoteDataFromFlash	getQuickNoteDataFromFlash.c
get_system_data_24_alt	get_system_data_24_alt.c
QuickNoteStoreHandler	QuickNoteStoreHandler.c
adc_nfc_init	adc_nfc_init.c
adc_nfc_run	adc_nfc_run.c
handle_state_checking	handle_state_checking.c
calculate_time_difference	calculate_time_difference.c
set_timestamp	set_timestamp.c
calculate_mathematical_result_alt2	calculate_mathematical_result_alt2.c
handle_data_writing_alt	handle_data_writing_alt.c
handle_complex_data_processing_alt	handle_complex_data_processing_alt.c
handle_data_writing_alt2	handle_data_writing_alt2.c
handle_data_writing_with_validation	handle_data_writing_with_validation.c
handle_complex_data_writing	handle_complex_data_writing.c
handle_data_writing_with_state	handle_data_writing_with_state.c
initialize_data_structure_alt	initialize_data_structure_alt.c
initialize_data_structure_alt2	initialize_data_structure_alt2.c
handle_complex_data_processing_and_writing	handle_complex_data_processing_and_writing.c
get_system_byte_3	get_system_byte_3.c
initialize_system_and_adc_nfc	initialize_system_and_adc_nfc.c
determine_work_mode_state	determine_work_mode_state.c
update_adc_nfc_reference_value	update_adc_nfc_reference_value.c
get_adc_nfc_current_value	get_adc_nfc_current_value.c
check_adc_nfc_threshold_exceeded	check_adc_nfc_threshold_exceeded.c
monitor_adc_nfc_threshold_event	monitor_adc_nfc_threshold_event.c
process_adc_nfc_threshold_event	process_adc_nfc_threshold_event.c
process_adc_nfc_sensor_data_and_state	process_adc_nfc_sensor_data_and_state.c
manage_adc_nfc_system_state	manage_adc_nfc_system_state.c
check_and_enter_long_trip_mode	check_and_enter_long_trip_mode.c
retry_nfc_operation_with_backoff	retry_nfc_operation_with_backoff.c
format_and_send_data_packet	format_and_send_data_packet.c
send_data_packet_with_retry_and_mutex	send_data_packet_with_retry_and_mutex.c
send_control_message_with_byte_swap	send_control_message_with_byte_swap.c
send_control_message_with_retry_and_mutex	send_control_message_with_retry_and_mutex.c
send_control_message_with_retry	send_control_message_with_retry.c
execute_resource_operation_with_retry	execute_resource_operation_with_retry.c
initialize_driver_context	initialize_driver_context.c
ipc0_ept_recv	ipc0_ept_recv.c
global_ipc_service_send	global_ipc_service_send.c
serialization_init	serialization_init.c
register_ipc_service_context	register_ipc_service_context.c
SendDashboardLockInfoToApp	SendDashboardLockInfoToApp.c
calculate_work_mode_parameters	calculate_work_mode_parameters.c
register_imu_funsion_context	register_imu_funsion_context.c
spi_master_trans_data_tx_rx	spi_master_trans_data_tx_rx.c
spi_master_deinit	spi_master_deinit.c
spi_master_init	spi_master_init.c
initialize_attitude_data_structure_with_defaults	initialize_attitude_data_structure_with_defaults.c
initialize_attitude_data_structure	initialize_attitude_data_structure.c
fast_inverse_square_root	fast_inverse_square_root.c
normalize_and_update_quaternion_attitude	normalize_and_update_quaternion_attitude.c
update_timing_and_calculate_rate	update_timing_and_calculate_rate.c
get_quaternion_component_scaled	get_quaternion_component_scaled.c
get_quaternion_component_scaled_alt	get_quaternion_component_scaled_alt.c
get_quaternion_component_scaled_with_offset	get_quaternion_component_scaled_with_offset.c
unlock_display_mutex	unlock_display_mutex.c
low_speed_peripheral_dispatch_thread_for_test	low_speed_peripheral_dispatch_thread_for_test.c
get_system_status_flag	get_system_status_flag.c
check_disp_onboarding	check_disp_onboarding.c
check_bind_status	check_bind_status.c
check_work_mode_and_ancs_status	check_work_mode_and_ancs_status.c
try_enter_low_power_mode	try_enter_low_power_mode.c
sync_to_slave	sync_to_slave.c
process_message_and_sync	process_message_and_sync.c
handle_message_confirmation_and_sync	handle_message_confirmation_and_sync.c
send_event_status	send_event_status.c
check_work_mode	check_work_mode.c
slave_display_thread	slave_display_thread.c
slave_display_main_thread	slave_display_main_thread.c
suspend_system_and_close_display	suspend_system_and_close_display.c
on_triple_click	on_triple_click.c
process_touch_sensor_events	process_touch_sensor_events.c
display_dispatch_thread	display_dispatch_thread.c
init_bluetooth_stack	init_bluetooth_stack.c
key_event_thread	key_event_thread.c
validate_spin_lock_if_enabled	validate_spin_lock_if_enabled.c
touch_key_thread	touch_key_thread.c
validate_spin_lock	validate_spin_lock.c
calculate_and_store_timestamp_with_offset	calculate_and_store_timestamp_with_offset.c
system_initialization_and_monitoring_loop	system_initialization_and_monitoring_loop.c
run_main_dispatch_thread	run_main_dispatch_thread.c
check_sw0_status	check_sw0_status.c
low_speed_peripheral_dispatch_thread	low_speed_peripheral_dispatch_thread.c
init_watchdog	init_watchdog.c
execute_hardware_operation_with_retry	execute_hardware_operation_with_retry.c
disable_watchdog	disable_watchdog.c
master_process_get_req	master_process_get_req.c
trigger_screen_state_change	trigger_screen_state_change.c
update_imu_trigger_status	update_imu_trigger_status.c
manage_imu_trigger_and_screen_state	manage_imu_trigger_and_screen_state.c
global_system_suspend	global_system_suspend.c
now_has_persist_task	now_has_persist_task.c
check_work_mode_state_valid	check_work_mode_state_valid.c
update_persist_task_status	update_persist_task_status.c
update_temp_task_status	update_temp_task_status.c
update_persist_task_status_to_idle	update_persist_task_status_to_idle.c
update_persist_task_status_to_wait_blow_head	update_persist_task_status_to_wait_blow_head.c
check_timeout_message_states_and_set_flag	check_timeout_message_states_and_set_flag.c
reset_display_ai_show_flag	reset_display_ai_show_flag.c
sync_message_signal_to_slave	sync_message_signal_to_slave.c
handle_message_expiration_and_sync	handle_message_expiration_and_sync.c
map_work_mode_to_state_value	map_work_mode_to_state_value.c
manage_system_status_and_timeout_transitions	manage_system_status_and_timeout_transitions.c
process_message_with_timeout_and_sync	process_message_with_timeout_and_sync.c
process_for_new_message_come_on	process_for_new_message_come_on.c
process_for_message_show	process_for_message_show.c
process_for_even_ai_show	process_for_even_ai_show.c
ext_flash_read	ext_flash_read.c
ext_flash_write	ext_flash_write.c
ext_flash_api_init	ext_flash_api_init.c
opt3001_reg_read	opt3001_reg_read.c
opt3001_read_lux_value	opt3001_read_lux_value.c
opt3007_chip_init	opt3007_chip_init.c
opt3007_chip_deinit	opt3007_chip_deinit.c
initialize_data_structure_with_pointers	initialize_data_structure_with_pointers.c
read_sensor_temperature_data	read_sensor_temperature_data.c
process_imu_sensor_data_and_temperature	process_imu_sensor_data_and_temperature.c
format_and_send_sensor_data	format_and_send_sensor_data.c
format_and_send_sensor_data_alt	format_and_send_sensor_data_alt.c
check_sensor_status_and_format_data	check_sensor_status_and_format_data.c
set_sensor_enable_state	set_sensor_enable_state.c
compare_and_update_sensor_data	compare_and_update_sensor_data.c
compare_and_update_sensor_data_alt	compare_and_update_sensor_data_alt.c
compare_and_update_sensor_data_alt2	compare_and_update_sensor_data_alt2.c
reset_sensor_data_buffers	reset_sensor_data_buffers.c
init_dmic_msgq	init_dmic_msgq.c
clean_dmic_msgq	clean_dmic_msgq.c
enqueue_dmic	enqueue_dmic.c
get_sensor_data_buffer_address	get_sensor_data_buffer_address.c
dequeue_dmic	dequeue_dmic.c
app_codec_lc3_test	app_codec_lc3_test.c
get_work_mode_config_value	get_work_mode_config_value.c
enable_dmic_stream	enable_dmic_stream.c
set_dmic_stream_state	set_dmic_stream_state.c
erase_audio_buffer	erase_audio_buffer.c
do_pdm_transfer	do_pdm_transfer.c
getAudioMessageQueueCacheData	getAudioMessageQueueCacheData.c
delVoiceBlock	delVoiceBlock.c
process_sensor_data_buffer	process_sensor_data_buffer.c
sendAudioStram2Cache	sendAudioStram2Cache.c
get_sensor_data_buffer_address_alt	get_sensor_data_buffer_address_alt.c
startAudioStreamRecord	startAudioStreamRecord.c
stopAudioStreamRecord	stopAudioStreamRecord.c
delAudioStreamRecord	delAudioStreamRecord.c
exchange_sensor_data_value	exchange_sensor_data_value.c
get_and_reset_sensor_data_value	get_and_reset_sensor_data_value.c
get_sensor_data_value	get_sensor_data_value.c
audioStreamFileManagerHandler	audioStreamFileManagerHandler.c
call_sensor_callback_function	call_sensor_callback_function.c
transmit_sensor_data_with_retry	transmit_sensor_data_with_retry.c
configure_sensor_parameters	configure_sensor_parameters.c
initialize_sensor_registers	initialize_sensor_registers.c
set_sensor_operation_mode	set_sensor_operation_mode.c
verify_sensor_data_checksum	verify_sensor_data_checksum.c
read_sensor_data_with_retry	read_sensor_data_with_retry.c
process_sensor_data_packet	process_sensor_data_packet.c
check_sensor_status_and_validate	check_sensor_status_and_validate.c
configure_and_validate_sensor_parameters	configure_and_validate_sensor_parameters.c
configure_sensor_with_checksum_verification	configure_sensor_with_checksum_verification.c
calibrate_sensor_with_data_validation	calibrate_sensor_with_data_validation.c
monitor_sensor_status_and_initialize	monitor_sensor_status_and_initialize.c
initialize_and_configure_sensor_complete	initialize_and_configure_sensor_complete.c
transmit_sensor_data_packet	transmit_sensor_data_packet.c
initialize_sensor_system	initialize_sensor_system.c
get_sensor_system_status	get_sensor_system_status.c
set_sensor_system_status	set_sensor_system_status.c
reset_sensor_system_status	reset_sensor_system_status.c
transmit_sensor_data_with_validation	transmit_sensor_data_with_validation.c
format_sensor_data_response	format_sensor_data_response.c
get_work_mode_data_response	get_work_mode_data_response.c
set_brightness_lum_base	set_brightness_lum_base.c
verify_system_settings_and_format_response	verify_system_settings_and_format_response.c
set_glasses_sn_info	set_glasses_sn_info.c
get_assign_channel_info	get_assign_channel_info.c
set_device_sn_info	set_device_sn_info.c
configure_user_settings_and_verify	configure_user_settings_and_verify.c
configure_system_mode_and_verify	configure_system_mode_and_verify.c
mic_transm_thread	mic_transm_thread.c
mx25r6435f_0	mx25r6435f_0.c
monitor_sensor_status_periodically	monitor_sensor_status_periodically.c
get_glassbox_charge_status	get_glassbox_charge_status.c
get_glassbox_charge_percent	get_glassbox_charge_percent.c
set_sensor_status_bits	set_sensor_status_bits.c
route_command_to_handler	route_command_to_handler.c
set_next_timing_deadline	set_next_timing_deadline.c
is_ext_flash_burned	is_ext_flash_burned.c
get_system_ready_state	get_system_ready_state.c
log_debug_message_with_heartbeat	log_debug_message_with_heartbeat.c
set_sensor_debug_flag	set_sensor_debug_flag.c
initialize_sensor_driver	initialize_sensor_driver.c
configure_sensor_driver_parameters	configure_sensor_driver_parameters.c
set_sensor_configuration_parameter	set_sensor_configuration_parameter.c
set_sensor_configuration_parameter_alt	set_sensor_configuration_parameter_alt.c
cleanup_sensor_system	cleanup_sensor_system.c
cleanup_sensor_system_alt	cleanup_sensor_system_alt.c
enter_into_long_trip	enter_into_long_trip.c
initialize_sensor_driver_with_validation	initialize_sensor_driver_with_validation.c
initialize_sensor_system_complete	initialize_sensor_system_complete.c
uart_callback	uart_callback.c
configure_sensor_driver_interface	configure_sensor_driver_interface.c
process_data_with_validation_and_retry	process_data_with_validation_and_retry.c
post_notification_cmd_process	post_notification_cmd_process.c
process_data_and_send_response	process_data_and_send_response.c
log_timeout_message_states_for_debugging	log_timeout_message_states_for_debugging.c
log_debug_messages_with_heartbeat	log_debug_messages_with_heartbeat.c
get_message_buffer_data	get_message_buffer_data.c
get_system_status_with_validation	get_system_status_with_validation.c
set_message_state	set_message_state.c
get_data_by_index_offset	get_data_by_index_offset.c
find_data_by_parameter	find_data_by_parameter.c
get_message_state_table_entry	get_message_state_table_entry.c
initialize_system_data_structures	initialize_system_data_structures.c
find_active_system_status	find_active_system_status.c
count_active_system_entries	count_active_system_entries.c
calculate_next_timeout_message_state	calculate_next_timeout_message_state.c
clear_timeout_message	clear_timeout_message.c
validate_data_entry_exists	validate_data_entry_exists.c
push_message	push_message.c
post_notification_cmd_response	post_notification_cmd_response.c
manage_timeout_message_states	manage_timeout_message_states.c
pull_message	pull_message.c
get_system_initialization_flag	get_system_initialization_flag.c
advance_timeout_message_state	advance_timeout_message_state.c
get_system_status_value	get_system_status_value.c
decrement_timer_counter	decrement_timer_counter.c
control_timer_operation	control_timer_operation.c
is_msg_expiration	is_msg_expiration.c
confirm_message	confirm_message.c
check_work_mode_timestamp_status	check_work_mode_timestamp_status.c
check_system_status_conditions	check_system_status_conditions.c
validate_data_entry_format	validate_data_entry_format.c
initialize_system_timers_and_whitelist	initialize_system_timers_and_whitelist.c
parse_ncs_notification	parse_ncs_notification.c
read_and_validate_whitelist_app_flash_settings	read_and_validate_whitelist_app_flash_settings.c
get_system_timer_value	get_system_timer_value.c
validate_app_whitelist	validate_app_whitelist.c
parse_whitelist_app_json	parse_whitelist_app_json.c
compare_string_data_arrays	compare_string_data_arrays.c
validate_whitelist_app_data	validate_whitelist_app_data.c
create_whitelist_app_json_structure	create_whitelist_app_json_structure.c
process_whitelist_app_packet_data	process_whitelist_app_packet_data.c
allocate_and_init_whitelist_verification_buffer	allocate_and_init_whitelist_verification_buffer.c
verify_whitelist_app_chunked_data	verify_whitelist_app_chunked_data.c
handle_whitelist_app_from_app	handle_whitelist_app_from_app.c
format_and_display_time_difference	format_and_display_time_difference.c
render_ui_data_entry_display	render_ui_data_entry_display.c
process_framebuffer_with_ui_overlay	process_framebuffer_with_ui_overlay.c
set_framebuffer_processing_flag	set_framebuffer_processing_flag.c
set_message_processing_active_flag	set_message_processing_active_flag.c
dump_template_gyro_info	dump_template_gyro_info.c
process_chinese_character_bitmaps	process_chinese_character_bitmaps.c
update_timing_and_adjust_parameters	update_timing_and_adjust_parameters.c
render_time_display_with_bitmaps	render_time_display_with_bitmaps.c
encode_data_to_byte_pattern	encode_data_to_byte_pattern.c
process_encoded_data_from_flash	process_encoded_data_from_flash.c
convert_2bit_to_4bit_pixels	convert_2bit_to_4bit_pixels.c
load_bmp_image_from_flash	load_bmp_image_from_flash.c
validate_and_set_parameter_bounds	validate_and_set_parameter_bounds.c
increment_parameter_counter_with_wrap	increment_parameter_counter_with_wrap.c
update_screen_display	update_screen_display.c
render_ui_status_display	render_ui_status_display.c
check_system_status_and_copy_data	check_system_status_and_copy_data.c
get_work_mode_status	get_work_mode_status.c
set_system_parameter_and_byte	set_system_parameter_and_byte.c
reset_system_parameter_and_byte	reset_system_parameter_and_byte.c
get_system_parameter_value	get_system_parameter_value.c
get_and_log_system_parameter	get_and_log_system_parameter.c
set_system_parameter_with_logging	set_system_parameter_with_logging.c
log_system_status	log_system_status.c
get_and_log_system_parameter_alt	get_and_log_system_parameter_alt.c
set_system_parameter_with_logging_alt	set_system_parameter_with_logging_alt.c
clear_work_mode_flags	clear_work_mode_flags.c
render_dashboard_ui	render_dashboard_ui.c
process_timeout_message_state_and_send_response	process_timeout_message_state_and_send_response.c
process_timeout_message_state_alt_and_send_response	process_timeout_message_state_alt_and_send_response.c
manage_dashboard_ui_operations	manage_dashboard_ui_operations.c
dmic_record_start	dmic_record_start.c
stop_audio_and_enable_dmic_stream	stop_audio_and_enable_dmic_stream.c
ui_QuickNote_task	ui_QuickNote_task.c
handle_display_mode_change	handle_display_mode_change.c
ui_even_ai_task	ui_even_ai_task.c
reset_audio_stream_flag	reset_audio_stream_flag.c
manage_ui_animation_state_and_rendering	manage_ui_animation_state_and_rendering.c
not_disturb_sync_data	not_disturb_sync_data.c
clear_memory_buffer_0x230	clear_memory_buffer_0x230.c
ui_teleprompter_task	ui_teleprompter_task.c
clear_memory_buffer_0x38	clear_memory_buffer_0x38.c
navigation_direction_img_display	navigation_direction_img_display.c
navigation_overview_map_display	navigation_overview_map_display.c
navigation_panoramic_map_display	navigation_panoramic_map_display.c
render_ui_text_based_on_system_mode	render_ui_text_based_on_system_mode.c
render_ui_text_alt_based_on_system_mode	render_ui_text_alt_based_on_system_mode.c
draw_template_translate_screen	draw_template_translate_screen.c
initialize_work_mode_buffer_and_flag	initialize_work_mode_buffer_and_flag.c
validate_and_update_work_mode_state	validate_and_update_work_mode_state.c
render_work_mode_ui_based_on_state	render_work_mode_ui_based_on_state.c
manage_complex_work_mode_animations_and_states	manage_complex_work_mode_animations_and_states.c
check_work_mode_state_conditions	check_work_mode_state_conditions.c
onboarding_ble_process	onboarding_ble_process.c
onboarding_sync_data	onboarding_sync_data.c
ui_onboarding_task	ui_onboarding_task.c
cal_panel_canvas_coord	cal_panel_canvas_coord.c
ui_raster_height_task	ui_raster_height_task.c
get_display_config_flags	get_display_config_flags.c
set_work_mode_parameter	set_work_mode_parameter.c
gui_screen_clear	gui_screen_clear.c
gui_area_clear	gui_area_clear.c
set_work_mode_flag_bit_1	set_work_mode_flag_bit_1.c
clear_work_mode_flag_bit_1	clear_work_mode_flag_bit_1.c
reset_animation_counters	reset_animation_counters.c
clear_ui_area	clear_ui_area.c
gui_bmp_dynamic_bitmap_draw	gui_bmp_dynamic_bitmap_draw.c
gui_bmp_bitmap_draw	gui_bmp_bitmap_draw.c
gui_bmp_bitmap_draw_ex	gui_bmp_bitmap_draw_ex.c
reset_animation_counters	reset_animation_counters.c
animate_framebuffer_with_pattern	animate_framebuffer_with_pattern.c
animate_framebuffer_with_pattern_alt	animate_framebuffer_with_pattern_alt.c
gui_verticalLine_process_bar	gui_verticalLine_process_bar.c
gui_bitmap_draw	gui_bitmap_draw.c
gui_bitmps_merge_draw	gui_bitmps_merge_draw.c
gui_4bit_bitmap_override	gui_4bit_bitmap_override.c
count_matching_data_entries	count_matching_data_entries.c
gui_utf_draw	gui_utf_draw.c
render_ui_with_framebuffer_management	render_ui_with_framebuffer_management.c
EVEN_DASHBOARD_CLOCK_32x_TTF	EVEN_DASHBOARD_CLOCK_32x_TTF.c
gui_utf_draw_dark_light_split	gui_utf_draw_dark_light_split.c
gui_utf_draw_truncate	gui_utf_draw_truncate.c
gui_utf_draw_middle	gui_utf_draw_middle.c
gui_utf_draw_align_right	gui_utf_draw_align_right.c
gui_utf_Wordwrap_draw	gui_utf_Wordwrap_draw.c
gui_string_draw	gui_string_draw.c
get_data_by_index_and_type	get_data_by_index_and_type.c
find_data_structure_by_id	find_data_structure_by_id.c
find_data_structure_by_id_alt	find_data_structure_by_id_alt.c
find_data_structure_by_id_alt2	find_data_structure_by_id_alt2.c
find_data_structure_by_id_alt3	find_data_structure_by_id_alt3.c
_012_resource_manger_get	_012_resource_manger_get.c
get_value_by_index_limited_range	get_value_by_index_limited_range.c
set_imu_pitch_reflash	set_imu_pitch_reflash.c
ui_set_imu_pitch_task	ui_set_imu_pitch_task.c
panel_off	panel_off.c
panel_on	panel_on.c
set_brightness_to_panel_reg	set_brightness_to_panel_reg.c
jbd_panel_init	jbd_panel_init.c
write_registers_if_changed	write_registers_if_changed.c
set_brightness_to_panel_reg_in_running	set_brightness_to_panel_reg_in_running.c
initialize_memory_structure_with_allocation	initialize_memory_structure_with_allocation.c
_clean_fb_data	_clean_fb_data.c
_reflash_fb_data_to_lcd	_reflash_fb_data_to_lcd.c
_reflash_fb_data_to_lcd_ex	_reflash_fb_data_to_lcd_ex.c
panel_init	panel_init.c
jbd_panel_suspend	jbd_panel_suspend.c
jbd_panel_resume	jbd_panel_resume.c
jbd_spi_command	jbd_spi_command.c
mutex_unlock_jbd_display	mutex_unlock_jbd_display.c
send_jbd_battery_command	send_jbd_battery_command.c
spi_read_id	spi_read_id.c
utf8_to_unicode	utf8_to_unicode.c
convert_utf8_to_unicode_with_validation	convert_utf8_to_unicode_with_validation.c
convert_string_to_unicode_buffer	convert_string_to_unicode_buffer.c
apply_color_lookup_table	apply_color_lookup_table.c
find_chinese_bitmap_by_unicode	find_chinese_bitmap_by_unicode.c
get_bitmap_data_by_index	get_bitmap_data_by_index.c
get_display_dimensions_and_bitmap	get_display_dimensions_and_bitmap.c
call_data_verification_if_needed	call_data_verification_if_needed.c
process_data_with_verification	process_data_with_verification.c
send_response_data_to_msgqueue	send_response_data_to_msgqueue.c
enqueue_message_to_queue_with_work_mode_check	enqueue_message_to_queue_with_work_mode_check.c
send_audio_stream_file_to_app	send_audio_stream_file_to_app.c
proxy_thread_handler	proxy_thread_handler.c
requestAudioInfoToApp	requestAudioInfoToApp.c
SendPowerInfoToSlave	SendPowerInfoToSlave.c
SendSystemLanguageInfoToSlave	SendSystemLanguageInfoToSlave.c
double_click_start	double_click_start.c
SlaveDoubleClickEventInject	SlaveDoubleClickEventInject.c
set_parameter_with_bounds_check	set_parameter_with_bounds_check.c
route_ui_tasks	route_ui_tasks.c
display_reflash_handler	display_reflash_handler.c
setup_font_rendering_system	setup_font_rendering_system.c
setDelayExitValue	setDelayExitValue.c
get_font_rendering_flag	get_font_rendering_flag.c
call_function_with_font_parameters	call_function_with_font_parameters.c
call_function_conditionally_with_flag	call_function_conditionally_with_flag.c
display_thread_handler	display_thread_handler.c
process_data_with_large_buffer	process_data_with_large_buffer.c
display_reflash	display_reflash.c
display_close	display_close.c
display_close_screen	display_close_screen.c
display_DelayClose	display_DelayClose.c
display_inputEvent	display_inputEvent.c
display_MasterSendClose	display_MasterSendClose.c
display_powerEvent	display_powerEvent.c
initialize_data_structure_with_offsets	initialize_data_structure_with_offsets.c
calculate_md5_hash	calculate_md5_hash.c
pad_and_process_data_with_length	pad_and_process_data_with_length.c
unix_timestamp_to_datetime	unix_timestamp_to_datetime.c
convert_timestamp_and_debug_print	convert_timestamp_and_debug_print.c
convert_float_to_string_with_sign	convert_float_to_string_with_sign.c
log_notification_data	log_notification_data.c
dump_hex_data	dump_hex_data.c
update_timer_interval	update_timer_interval.c
set_system_timestamp	set_system_timestamp.c
calculate_elapsed_time	calculate_elapsed_time.c
convert_timestamp_to_seconds	convert_timestamp_to_seconds.c
get_boot_seconds	get_boot_seconds.c
uint32_to_little_endian	uint32_to_little_endian.c
update_burial_point_day_index	update_burial_point_day_index.c
enter_wear_burial_point	enter_wear_burial_point.c
get_dashboard_sum_time	get_dashboard_sum_time.c
enter_dashboard_burial_point	enter_dashboard_burial_point.c
exit_dashboard_burial_point	exit_dashboard_burial_point.c
burial_point_record_info_init	burial_point_record_info_init.c
execute_empty_loop	execute_empty_loop.c
process_data_with_callback_and_validation	process_data_with_callback_and_validation.c
validate_parameter_and_set_error	validate_parameter_and_set_error.c
decrement_reference_count	decrement_reference_count.c
execute_resource_function_with_mutex	execute_resource_function_with_mutex.c
execute_resource_function_with_mutex_alt	execute_resource_function_with_mutex_alt.c
execute_resource_function_with_mutex_and_cleanup	execute_resource_function_with_mutex_and_cleanup.c
execute_resource_function_with_validation	execute_resource_function_with_validation.c
set_resource_parameter	set_resource_parameter.c
format_and_print_string	format_and_print_string.c
format_string_with_length_check	format_string_with_length_check.c
manage_heap_chunk_with_validation	manage_heap_chunk_with_validation.c
allocate_heap_memory_with_alignment	allocate_heap_memory_with_alignment.c
manage_task_state_and_priority	manage_task_state_and_priority.c
manage_task_state_transition_with_priority_control	manage_task_state_transition_with_priority_control.c
manage_task_state_decrement_with_priority_control	manage_task_state_decrement_with_priority_control.c
handle_task_completion_state_transition	handle_task_completion_state_transition.c
parse_decimal_string_to_integer	parse_decimal_string_to_integer.c
format_integer_to_string_with_radix	format_integer_to_string_with_radix.c
initialize_bluetooth_stack_with_configuration	initialize_bluetooth_stack_with_configuration.c
execute_bluetooth_callback_with_priority_control	execute_bluetooth_callback_with_priority_control.c
system_fatal_error_handler_with_priority_control	system_fatal_error_handler_with_priority_control.c
check_and_update_system_heartbeat_timing	check_and_update_system_heartbeat_timing.c
manage_sensor_interrupt_configuration	manage_sensor_interrupt_configuration.c
setup_synchronized_rtc_with_sensor_interrupts	setup_synchronized_rtc_with_sensor_interrupts.c
configure_sensor_timing_and_interrupts	configure_sensor_timing_and_interrupts.c
enter_system_wait_state_with_data_synchronization	enter_system_wait_state_with_data_synchronization.c
process_data_buffer_with_alignment_handling	process_data_buffer_with_alignment_handling.c
process_complex_data_structure_with_encoding	process_complex_data_structure_with_encoding.c
search_and_update_data_structure_with_mutex_protection	search_and_update_data_structure_with_mutex_protection.c
search_data_structure_with_count_and_retrieval	search_data_structure_with_count_and_retrieval.c
execute_callback_function_with_validation	execute_callback_function_with_validation.c
execute_callback_with_context_validation	execute_callback_with_context_validation.c
execute_callback_with_pointer_validation	execute_callback_with_pointer_validation.c
process_resource_allocation_with_callback	process_resource_allocation_with_callback.c
check_and_allocate_memory_with_fallback	check_and_allocate_memory_with_fallback.c
initialize_complex_resource_structure_with_memory_allocation	initialize_complex_resource_structure_with_memory_allocation.c
process_data_with_validation_and_retry	process_data_with_validation_and_retry.c
allocate_and_initialize_resource_buffer_with_string_copy	allocate_and_initialize_resource_buffer_with_string_copy.c
search_and_update_resource_entries_with_callback	search_and_update_resource_entries_with_callback.c
add_resource_entry_with_validation	add_resource_entry_with_validation.c
manage_resource_buffer_allocation	manage_resource_buffer_allocation.c
initialize_resource_structure_with_memory_layout	initialize_resource_structure_with_memory_layout.c
process_bit_flags_with_callback_execution	process_bit_flags_with_callback_execution.c
process_system_tasks_with_priority_management	process_system_tasks_with_priority_management.c
get_system_parameter_by_index	get_system_parameter_by_index.c
get_and_reset_system_flag	get_and_reset_system_flag.c
process_system_callbacks_with_flag_reset	process_system_callbacks_with_flag_reset.c
initialize_bluetooth_stack_and_store_previous_state	initialize_bluetooth_stack_and_store_previous_state.c
allocate_memory_with_priority_management	allocate_memory_with_priority_management.c
process_memory_allocation_with_priority_control	process_memory_allocation_with_priority_control.c
process_memory_deallocation_with_priority_control	process_memory_deallocation_with_priority_control.c
process_memory_management_with_timing_control	process_memory_management_with_timing_control.c
process_system_tasks_and_memory_management	process_system_tasks_and_memory_management.c
main_system_logging_and_monitoring_loop	main_system_logging_and_monitoring_loop.c
get_system_parameter_by_offset	get_system_parameter_by_offset.c
initialize_task_entry_with_priority_and_state	initialize_task_entry_with_priority_and_state.c
process_and_compress_data_with_validation	process_and_compress_data_with_validation.c
process_task_completion_with_callback_execution	process_task_completion_with_callback_execution.c
process_task_completion_with_priority_based_callback	process_task_completion_with_priority_based_callback.c
process_task_completion_with_state_management	process_task_completion_with_state_management.c
process_data_with_callback_execution	process_data_with_callback_execution.c
process_data_with_validation_and_callback	process_data_with_validation_and_callback.c
process_data_with_state_validation	process_data_with_state_validation.c
process_data_with_callback_validation	process_data_with_callback_validation.c
process_data_with_parameter_validation	process_data_with_parameter_validation.c
process_data_with_callback_and_parameter	process_data_with_callback_and_parameter.c
setup_device_buffer_with_validation	setup_device_buffer_with_validation.c
setup_device_buffer_with_parameters	setup_device_buffer_with_parameters.c
setup_device_buffer_with_flags	setup_device_buffer_with_flags.c
setup_device_buffer_with_size	setup_device_buffer_with_size.c
initialize_buffer_structure	initialize_buffer_structure.c
initialize_buffer_structure_with_parameters	initialize_buffer_structure_with_parameters.c
initialize_buffer_structure_with_flags	initialize_buffer_structure_with_flags.c
initialize_buffer_structure_with_size	initialize_buffer_structure_with_size.c
initialize_buffer_structure_with_validation	initialize_buffer_structure_with_validation.c
initialize_buffer_structure_with_callback	initialize_buffer_structure_with_callback.c
initialize_buffer_structure_with_context	initialize_buffer_structure_with_context.c
initialize_buffer_structure_with_memory	initialize_buffer_structure_with_memory.c
handle_configuration_setting	handle_configuration_setting.c
handle_configuration_setting_with_validation	handle_configuration_setting_with_validation.c
handle_configuration_setting_with_callback	handle_configuration_setting_with_callback.c
handle_configuration_setting_with_parameters	handle_configuration_setting_with_parameters.c
handle_configuration_setting_with_flags	handle_configuration_setting_with_flags.c
handle_configuration_setting_with_context	handle_configuration_setting_with_context.c
handle_configuration_setting_with_memory	handle_configuration_setting_with_memory.c
handle_configuration_setting_with_size	handle_configuration_setting_with_size.c
handle_configuration_setting_with_validation_and_callback	handle_configuration_setting_with_validation_and_callback.c
copy_data_with_error_handling	copy_data_with_error_handling.c
process_data_with_state_management	process_data_with_state_management.c
process_data_with_validation_and_retry_alt	process_data_with_validation_and_retry_alt.c
process_data_with_callback_and_validation_alt	process_data_with_callback_and_validation_alt.c
process_data_with_state_management_alt	process_data_with_state_management_alt.c
process_data_with_parameter_validation_alt	process_data_with_parameter_validation_alt.c
process_data_with_callback_execution_alt	process_data_with_callback_execution_alt.c
process_data_with_validation_and_callback_alt	process_data_with_validation_and_callback_alt.c
process_data_with_state_validation_alt	process_data_with_state_validation_alt.c
process_data_with_callback_validation_alt	process_data_with_callback_validation_alt.c
process_data_with_parameter_validation_alt2	process_data_with_parameter_validation_alt2.c
process_data_with_callback_and_parameter_alt	process_data_with_callback_and_parameter_alt.c
process_data_with_validation_and_parameter_alt	process_data_with_validation_and_parameter_alt.c
process_data_with_callback_execution_alt2	process_data_with_callback_execution_alt2.c
process_data_with_state_management_alt2	process_data_with_state_management_alt2.c
process_data_with_validation_and_callback_alt2	process_data_with_validation_and_callback_alt2.c
process_data_with_callback_validation_alt2	process_data_with_callback_validation_alt2.c
process_data_with_parameter_validation_alt3	process_data_with_parameter_validation_alt3.c
process_data_with_callback_and_parameter_alt2	process_data_with_callback_and_parameter_alt2.c
process_data_with_validation_and_parameter_alt2	process_data_with_validation_and_parameter_alt2.c
process_data_with_callback_execution_alt3	process_data_with_callback_execution_alt3.c
process_data_with_state_management_alt3	process_data_with_state_management_alt3.c
process_data_with_validation_and_callback_alt3	process_data_with_validation_and_callback_alt3.c
process_data_with_callback_validation_alt3	process_data_with_callback_validation_alt3.c
process_data_with_parameter_validation_alt4	process_data_with_parameter_validation_alt4.c
process_data_with_callback_and_parameter_alt3	process_data_with_callback_and_parameter_alt3.c
process_data_with_validation_and_parameter_alt3	process_data_with_validation_and_parameter_alt3.c
process_data_with_callback_execution_alt4	process_data_with_callback_execution_alt4.c
process_data_with_state_management_alt4	process_data_with_state_management_alt4.c
process_data_with_validation_and_callback_alt4	process_data_with_validation_and_callback_alt4.c
process_data_with_callback_validation_alt4	process_data_with_callback_validation_alt4.c
process_data_with_parameter_validation_alt5	process_data_with_parameter_validation_alt5.c
process_data_with_callback_and_parameter_alt4	process_data_with_callback_and_parameter_alt4.c
process_data_with_validation_and_parameter_alt4	process_data_with_validation_and_parameter_alt4.c
process_data_with_callback_execution_alt5	process_data_with_callback_execution_alt5.c
process_data_with_state_management_alt5	process_data_with_state_management_alt5.c
process_data_with_validation_and_callback_alt5	process_data_with_validation_and_callback_alt5.c
process_data_with_callback_validation_alt5	process_data_with_callback_validation_alt5.c
process_data_with_parameter_validation_alt6	process_data_with_parameter_validation_alt6.c
compress_data_with_validation	compress_data_with_validation.c
process_data_with_compression_and_validation	process_data_with_compression_and_validation.c
process_data_with_validation_and_compression	process_data_with_validation_and_compression.c
process_data_with_compression_and_validation_alt	process_data_with_compression_and_validation_alt.c
heap_allocate_memory	heap_allocate_memory.c
initialize_recursive_mutex	initialize_recursive_mutex.c
acquire_mutex	acquire_mutex.c
release_mutex	release_mutex.c
handle_buffer_overflow	handle_buffer_overflow.c
process_data_with_validation_and_retry_alt2	process_data_with_validation_and_retry_alt2.c
process_data_with_callback_and_validation_alt2	process_data_with_callback_and_validation_alt2.c
process_data_with_state_management_alt2	process_data_with_state_management_alt2.c
process_data_with_parameter_validation_alt2	process_data_with_parameter_validation_alt2.c
process_data_with_callback_execution_alt2	process_data_with_callback_execution_alt2.c
process_data_with_state_management_alt3	process_data_with_state_management_alt3.c
process_data_with_validation_and_callback_alt2	process_data_with_validation_and_callback_alt2.c
process_data_with_callback_validation_alt2	process_data_with_callback_validation_alt2.c
process_data_with_parameter_validation_alt3	process_data_with_parameter_validation_alt3.c
process_data_with_callback_and_parameter_alt2	process_data_with_callback_and_parameter_alt2.c
process_data_with_validation_and_parameter_alt3	process_data_with_validation_and_parameter_alt3.c
process_data_with_callback_execution_alt3	process_data_with_callback_execution_alt3.c
process_data_with_state_management_alt4	process_data_with_state_management_alt4.c
process_data_with_validation_and_callback_alt3	process_data_with_validation_and_callback_alt3.c
process_data_with_callback_validation_alt3	process_data_with_callback_validation_alt3.c
process_data_with_parameter_validation_alt4	process_data_with_parameter_validation_alt4.c
process_data_with_callback_and_parameter_alt3	process_data_with_callback_and_parameter_alt3.c
process_data_with_validation_and_parameter_alt4	process_data_with_validation_and_parameter_alt4.c
process_data_with_callback_execution_alt4	process_data_with_callback_execution_alt4.c
process_data_with_state_management_alt5	process_data_with_state_management_alt5.c
process_data_with_validation_and_callback_alt4	process_data_with_validation_and_callback_alt4.c
process_data_with_callback_validation_alt4	process_data_with_callback_validation_alt4.c
process_data_with_parameter_validation_alt5	process_data_with_parameter_validation_alt5.c
process_data_with_callback_and_parameter_alt4	process_data_with_callback_and_parameter_alt4.c
process_data_with_validation_and_parameter_alt5	process_data_with_validation_and_parameter_alt5.c
process_data_with_callback_execution_alt5	process_data_with_callback_execution_alt5.c
process_data_with_state_management_alt6	process_data_with_state_management_alt6.c
process_data_with_validation_and_callback_alt5	process_data_with_validation_and_callback_alt5.c
process_data_with_callback_validation_alt5	process_data_with_callback_validation_alt5.c
process_data_with_parameter_validation_alt6	process_data_with_parameter_validation_alt6.c
process_data_with_callback_and_parameter_alt5	process_data_with_callback_and_parameter_alt5.c
process_data_with_validation_and_parameter_alt6	process_data_with_validation_and_parameter_alt6.c
process_data_with_callback_execution_alt6	process_data_with_callback_execution_alt6.c
process_data_with_state_management_alt7	process_data_with_state_management_alt7.c
process_data_with_validation_and_callback_alt6	process_data_with_validation_and_callback_alt6.c
process_data_with_callback_validation_alt6	process_data_with_callback_validation_alt6.c
process_data_with_parameter_validation_alt7	process_data_with_parameter_validation_alt7.c
process_data_with_callback_and_parameter_alt6	process_data_with_callback_and_parameter_alt6.c
process_data_with_validation_and_parameter_alt7	process_data_with_validation_and_parameter_alt7.c
format_bluetooth_log_message	format_bluetooth_log_message.c
format_bluetooth_log_message_with_validation	format_bluetooth_log_message_with_validation.c
format_bluetooth_log_message_with_callback	format_bluetooth_log_message_with_callback.c
format_bluetooth_log_message_with_parameters	format_bluetooth_log_message_with_parameters.c
format_bluetooth_log_message_with_flags	format_bluetooth_log_message_with_flags.c
format_bluetooth_log_message_with_context	format_bluetooth_log_message_with_context.c
format_bluetooth_log_message_with_memory	format_bluetooth_log_message_with_memory.c
format_bluetooth_log_message_with_size	format_bluetooth_log_message_with_size.c
format_bluetooth_log_message_with_validation_and_callback	format_bluetooth_log_message_with_validation_and_callback.c
check_system_status_and_compress	check_system_status_and_compress.c
check_system_status_and_compress	check_system_status_and_compress.c
process_data_with_validation_and_compression_alt	process_data_with_validation_and_compression_alt.c
process_data_with_callback_and_compression_alt	process_data_with_callback_and_compression_alt.c
process_data_with_state_management_and_compression_alt	process_data_with_state_management_and_compression_alt.c
process_data_with_parameter_validation_and_compression_alt	process_data_with_parameter_validation_and_compression_alt.c
process_data_with_callback_execution_and_compression_alt	process_data_with_callback_execution_and_compression_alt.c
process_data_with_validation_and_callback_and_compression_alt	process_data_with_validation_and_callback_and_compression_alt.c
process_data_with_callback_validation_and_compression_alt	process_data_with_callback_validation_and_compression_alt.c
process_data_with_parameter_validation_and_compression_alt	process_data_with_parameter_validation_and_compression_alt.c
process_data_with_callback_and_parameter_and_compression_alt	process_data_with_callback_and_parameter_and_compression_alt.c
process_data_with_validation_and_parameter_and_compression_alt	process_data_with_validation_and_parameter_and_compression_alt.c
process_data_with_callback_execution_and_parameter_and_compression_alt	process_data_with_callback_execution_and_parameter_and_compression_alt.c
process_data_with_state_management_and_parameter_and_compression_alt	process_data_with_state_management_and_parameter_and_compression_alt.c
process_data_with_validation_and_state_management_and_compression_alt	process_data_with_validation_and_state_management_and_compression_alt.c
initialize_data_structure_and_store	initialize_data_structure_and_store.c
process_data_with_initialization_and_store	process_data_with_initialization_and_store.c
process_data_with_initialization_and_validation	process_data_with_initialization_and_validation.c
process_data_with_initialization_and_callback	process_data_with_initialization_and_callback.c
process_data_with_initialization_and_state_management	process_data_with_initialization_and_state_management.c
process_data_with_initialization_and_parameter_validation	process_data_with_initialization_and_parameter_validation.c
process_data_with_initialization_and_callback_execution	process_data_with_initialization_and_callback_execution.c
process_data_with_initialization_and_validation_and_callback	process_data_with_initialization_and_validation_and_callback.c
process_data_with_initialization_and_state_validation	process_data_with_initialization_and_state_validation.c
process_data_with_initialization_and_callback_validation	process_data_with_initialization_and_callback_validation.c
process_data_with_initialization_and_parameter_validation_and_callback	process_data_with_initialization_and_parameter_validation_and_callback.c
process_data_with_initialization_and_validation_and_state_management	process_data_with_initialization_and_validation_and_state_management.c
bluetooth_hci_command_processing_main_loop	bluetooth_hci_command_processing_main_loop.c
bluetooth_hci_command_processing_with_validation	bluetooth_hci_command_processing_with_validation.c
bluetooth_hci_command_processing_with_callback	bluetooth_hci_command_processing_with_callback.c
bluetooth_hci_command_processing_with_state_management	bluetooth_hci_command_processing_with_state_management.c
bluetooth_hci_command_processing_with_parameter_validation	bluetooth_hci_command_processing_with_parameter_validation.c
bluetooth_hci_command_processing_with_callback_execution	bluetooth_hci_command_processing_with_callback_execution.c
bluetooth_hci_command_processing_with_validation_and_callback	bluetooth_hci_command_processing_with_validation_and_callback.c
bluetooth_hci_command_processing_with_callback_validation	bluetooth_hci_command_processing_with_callback_validation.c
bluetooth_hci_command_processing_with_parameter_validation_and_callback	bluetooth_hci_command_processing_with_parameter_validation_and_callback.c
bluetooth_hci_command_processing_with_callback_execution_and_parameter	bluetooth_hci_command_processing_with_callback_execution_and_parameter.c
bluetooth_hci_command_processing_with_validation_and_parameter	bluetooth_hci_command_processing_with_validation_and_parameter.c
bluetooth_hci_command_processing_with_state_management_and_parameter	bluetooth_hci_command_processing_with_state_management_and_parameter.c
bluetooth_hci_command_processing_with_callback_and_parameter	bluetooth_hci_command_processing_with_callback_and_parameter.c
bluetooth_hci_command_processing_with_validation_and_callback_and_parameter	bluetooth_hci_command_processing_with_validation_and_callback_and_parameter.c
handle_bluetooth_privacy_mode_management	handle_bluetooth_privacy_mode_management.c
handle_bluetooth_privacy_mode_management_with_validation	handle_bluetooth_privacy_mode_management_with_validation.c
handle_bluetooth_privacy_mode_management_with_callback	handle_bluetooth_privacy_mode_management_with_callback.c
handle_bluetooth_privacy_mode_management_with_state_management	handle_bluetooth_privacy_mode_management_with_state_management.c
handle_bluetooth_privacy_mode_management_with_parameter_validation	handle_bluetooth_privacy_mode_management_with_parameter_validation.c
handle_bluetooth_privacy_mode_management_with_callback_execution	handle_bluetooth_privacy_mode_management_with_callback_execution.c
handle_bluetooth_privacy_mode_management_with_validation_and_callback	handle_bluetooth_privacy_mode_management_with_validation_and_callback.c
handle_bluetooth_privacy_mode_management_with_callback_validation	handle_bluetooth_privacy_mode_management_with_callback_validation.c
handle_bluetooth_privacy_mode_management_with_parameter_validation_and_callback	handle_bluetooth_privacy_mode_management_with_parameter_validation_and_callback.c
handle_bluetooth_privacy_mode_management_with_state_management_and_callback	handle_bluetooth_privacy_mode_management_with_state_management_and_callback.c
handle_bluetooth_privacy_mode_management_with_validation_and_state_management	handle_bluetooth_privacy_mode_management_with_validation_and_state_management.c
handle_bluetooth_privacy_mode_management_with_callback_execution_and_parameter	handle_bluetooth_privacy_mode_management_with_callback_execution_and_parameter.c
handle_bluetooth_privacy_mode_management_with_validation_and_callback_execution	handle_bluetooth_privacy_mode_management_with_validation_and_callback_execution.c
handle_bluetooth_privacy_mode_management_with_state_validation	handle_bluetooth_privacy_mode_management_with_state_validation.c
handle_bluetooth_privacy_mode_management_with_callback_validation_and_parameter	handle_bluetooth_privacy_mode_management_with_callback_validation_and_parameter.c
validate_and_process_ble_characteristics	validate_and_process_ble_characteristics.c
validate_and_process_ble_characteristics_with_validation	validate_and_process_ble_characteristics_with_validation.c
validate_and_process_ble_characteristics_with_callback	validate_and_process_ble_characteristics_with_callback.c
validate_and_process_ble_characteristics_with_state_management	validate_and_process_ble_characteristics_with_state_management.c
validate_and_process_ble_characteristics_with_parameter_validation	validate_and_process_ble_characteristics_with_parameter_validation.c
validate_and_process_ble_characteristics_with_callback_execution	validate_and_process_ble_characteristics_with_callback_execution.c
validate_and_process_ble_characteristics_with_validation_and_callback	validate_and_process_ble_characteristics_with_validation_and_callback.c
validate_and_process_ble_characteristics_with_callback_validation	validate_and_process_ble_characteristics_with_callback_validation.c
validate_and_process_ble_characteristics_with_parameter_validation_and_callback	validate_and_process_ble_characteristics_with_parameter_validation_and_callback.c
validate_and_process_ble_characteristics_with_state_management_and_callback	validate_and_process_ble_characteristics_with_state_management_and_callback.c
validate_and_process_ble_characteristics_with_validation_and_state_management	validate_and_process_ble_characteristics_with_validation_and_state_management.c
validate_and_process_ble_characteristics_with_callback_execution_and_parameter	validate_and_process_ble_characteristics_with_callback_execution_and_parameter.c
validate_and_process_ble_characteristics_with_state_management_and_parameter	validate_and_process_ble_characteristics_with_state_management_and_parameter.c
validate_and_process_ble_characteristics_with_validation_and_state_management	validate_and_process_ble_characteristics_with_validation_and_state_management.c
validate_and_process_ble_characteristics_with_callback_validation_and_parameter	validate_and_process_ble_characteristics_with_callback_validation_and_parameter.c
validate_and_process_ble_characteristics_with_parameter_validation_and_callback	validate_and_process_ble_characteristics_with_parameter_validation_and_callback.c
validate_and_process_ble_characteristics_with_state_management_and_parameter	validate_and_process_ble_characteristics_with_state_management_and_parameter.c
validate_and_process_ble_characteristics_with_validation_and_state_management_and_parameter	validate_and_process_ble_characteristics_with_validation_and_state_management_and_parameter.c
validate_and_process_ble_characteristics_with_callback_execution_and_state_management	validate_and_process_ble_characteristics_with_callback_execution_and_state_management.c
validate_and_process_ble_characteristics_with_validation_and_callback_execution	validate_and_process_ble_characteristics_with_validation_and_callback_execution.c
validate_and_process_ble_characteristics_with_callback_validation_and_state_management	validate_and_process_ble_characteristics_with_callback_validation_and_state_management.c
bt_connection_state_transition	bt_connection_state_transition.c
bt_connection_state_transition_with_validation	bt_connection_state_transition_with_validation.c
bt_connection_state_transition_with_callback	bt_connection_state_transition_with_callback.c
bt_connection_state_transition_with_state_management	bt_connection_state_transition_with_state_management.c
bt_connection_state_transition_with_parameter_validation	bt_connection_state_transition_with_parameter_validation.c
bt_connection_state_transition_with_callback_execution	bt_connection_state_transition_with_callback_execution.c
bt_connection_disconnect	bt_connection_disconnect.c
bt_connection_disconnect_with_validation	bt_connection_disconnect_with_validation.c
bt_connection_disconnect_with_callback	bt_connection_disconnect_with_callback.c
bt_connection_disconnect_with_state_management	bt_connection_disconnect_with_state_management.c
bt_connection_disconnect_with_parameter_validation	bt_connection_disconnect_with_parameter_validation.c
bt_connection_disconnect_with_callback_execution	bt_connection_disconnect_with_callback_execution.c
bt_connection_disconnect_with_validation_and_callback	bt_connection_disconnect_with_validation_and_callback.c
bt_connection_disconnect_with_callback_validation	bt_connection_disconnect_with_callback_validation.c
bt_connection_disconnect_with_parameter_validation_and_callback	bt_connection_disconnect_with_parameter_validation_and_callback.c
bt_connection_disconnect_with_state_management_and_callback	bt_connection_disconnect_with_state_management_and_callback.c
bt_connection_disconnect_with_validation_and_state_management	bt_connection_disconnect_with_validation_and_state_management.c
bt_connection_disconnect_with_callbacks_and_params	bt_connection_disconnect_with_callbacks_and_params.c
bt_connection_disconnect_with_state_management_and_parameter	bt_connection_disconnect_with_state_management_and_parameter.c
bt_connection_disconnect_with_validation_and_state_management	bt_connection_disconnect_with_validation_and_state_management.c
bt_connection_disconnect_with_callback_validation_and_parameter	bt_connection_disconnect_with_callback_validation_and_parameter.c
bt_connection_disconnect_with_parameter_validation_and_callback	bt_connection_disconnect_with_parameter_validation_and_callback.c
bt_connection_disconnect_with_state_validation_and_callback	bt_connection_disconnect_with_state_validation_and_callback.c
bt_connection_disconnect_with_callback_and_state_validation	bt_connection_disconnect_with_callback_and_state_validation.c
bt_connection_disconnect_with_validation_and_callback_and_state_validation	bt_connection_disconnect_with_validation_and_callback_and_state_validation.c
bt_connection_disconnect_with_parameter_validation_and_callback_and_state_validation	bt_connection_disconnect_with_parameter_validation_and_callback_and_state_validation.c
bt_connection_disconnect_with_state_management_and_callback_and_state_validation	bt_connection_disconnect_with_state_management_and_callback_and_state_validation.c
bt_connection_disconnect_with_validation_and_state_management_and_callback_and_state_validation	bt_connection_disconnect_with_validation_and_state_management_and_callback_and_state_validation.c
bt_connection_disconnect_with_callback_execution_and_parameter_and_state_validation	bt_connection_disconnect_with_callback_execution_and_parameter_and_state_validation.c
bt_connection_disconnect_with_state_management_and_callback_execution_and_parameter	bt_connection_disconnect_with_state_management_and_callback_execution_and_parameter.c
bt_connection_disconnect_with_validation_and_state_management_and_callback_execution	bt_connection_disconnect_with_validation_and_state_management_and_callback_execution.c
bt_connection_disconnect_with_callback_validation_and_parameter_and_state_validation	bt_connection_disconnect_with_callback_validation_and_parameter_and_state_validation.c
bt_connection_disconnect_with_parameter_validation_and_callback_and_state_validation_and_callback_execution	bt_connection_disconnect_with_parameter_validation_and_callback_and_state_validation_and_callback_execution.c
bt_connection_disconnect_with_state_management_and_callback_validation_and_parameter	bt_connection_disconnect_with_state_management_and_callback_validation_and_parameter.c
bt_connection_disconnect_with_callback_and_parameter_and_state_validation_and_callback_execution	bt_connection_disconnect_with_callback_and_parameter_and_state_validation_and_callback_execution.c
bt_connection_disconnect_with_validation_and_callback_and_parameter_and_state_validation	bt_connection_disconnect_with_validation_and_callback_and_parameter_and_state_validation.c
bt_connection_disconnect_with_state_management_and_callback_and_parameter_and_state_validation	bt_connection_disconnect_with_state_management_and_callback_and_parameter_and_state_validation.c
bt_connection_disconnect_with_callback_execution_and_parameter_and_state_validation_and_callback	bt_connection_disconnect_with_callback_execution_and_parameter_and_state_validation_and_callback.c
bt_connection_disconnect_with_validation_and_callback_execution_and_parameter_and_state_validation	bt_connection_disconnect_with_validation_and_callback_execution_and_parameter_and_state_validation.c
bt_connection_disconnect_with_state_management_and_callback_execution_and_parameter_and_state_validation	bt_connection_disconnect_with_state_management_and_callback_execution_and_parameter_and_state_validation.c
bt_connection_disconnect_with_validation_and_state_management_and_callback_execution_and_parameter_and_state_validation_and_callback	bt_connection_disconnect_with_validation_and_state_management_and_callback_execution_and_parameter_and_state_validation_and_callback.c
bt_connection_disconnect_with_callback_validation_and_parameter_and_state_validation_and_callback_execution	bt_connection_disconnect_with_callback_validation_and_parameter_and_state_validation_and_callback_execution.c
bt_connection_disconnect_with_state_management_and_callback_validation_and_parameter_and_state_validation_and_callback_execution	bt_connection_disconnect_with_state_management_and_callback_validation_and_parameter_and_state_validation_and_callback_execution.c
bt_connection_disconnect_with_parameter_validation_and_callback_and_state_validation_and_callback_execution_and_parameter	bt_connection_disconnect_with_parameter_validation_and_callback_and_state_validation_and_callback_execution_and_parameter.c
bt_connection_disconnect_with_callback_and_parameter_and_state_validation_and_callback_execution_and_parameter_and_state_management	bt_connection_disconnect_with_callback_and_parameter_and_state_validation_and_callback_execution_and_parameter_and_state_management.c
bt_connection_disconnect_with_validation_and_callback_and_parameter_and_state_validation_and_callback_execution	bt_connection_disconnect_with_validation_and_callback_and_parameter_and_state_validation_and_callback_execution.c
bt_connection_disconnect_with_state_management_and_callback_and_parameter_and_state_validation_and_callback_execution_and_parameter	bt_connection_disconnect_with_state_management_and_callback_and_parameter_and_state_validation_and_callback_execution_and_parameter.c
allocate_and_initialize_att_connection_context	allocate_and_initialize_att_connection_context.c
process_ble_characteristic_value_change	process_ble_characteristic_value_change.c
process_ble_characteristic_value_change_with_validation	process_ble_characteristic_value_change_with_validation.c
process_ble_characteristic_value_change_with_callback	process_ble_characteristic_value_change_with_callback.c
process_ble_characteristic_value_change_with_state_management	process_ble_characteristic_value_change_with_state_management.c
process_ble_characteristic_value_change_with_parameter_validation	process_ble_characteristic_value_change_with_parameter_validation.c
process_ble_characteristic_value_change_with_callback_execution	process_ble_characteristic_value_change_with_callback_execution.c
process_ble_characteristic_value_change_with_validation_and_callback	process_ble_characteristic_value_change_with_validation_and_callback.c
process_ble_characteristic_value_change_with_callback_validation	process_ble_characteristic_value_change_with_callback_validation.c
process_ble_characteristic_value_change_with_parameter_validation_and_callback	process_ble_characteristic_value_change_with_parameter_validation_and_callback.c
process_ble_characteristic_value_change_with_state_management_and_callback	process_ble_characteristic_value_change_with_state_management_and_callback.c
process_ble_characteristic_value_change_with_validation_and_state_management	process_ble_characteristic_value_change_with_validation_and_state_management.c
process_ble_characteristic_value_change_with_callback_execution_and_parameter	process_ble_characteristic_value_change_with_callback_execution_and_parameter.c
handle_ble_connection_state_change	handle_ble_connection_state_change.c
handle_ble_connection_state_change_with_validation	handle_ble_connection_state_change_with_validation.c
handle_ble_connection_state_change_with_callback	handle_ble_connection_state_change_with_callback.c
handle_ble_connection_state_change_with_state_management	handle_ble_connection_state_change_with_state_management.c
handle_ble_connection_state_change_with_parameter_validation	handle_ble_connection_state_change_with_parameter_validation.c
cleanup_ble_connection_and_free_memory	cleanup_ble_connection_and_free_memory.c
handle_ble_connection_state_change_with_callback	handle_ble_connection_state_change_with_callback.c
process_ble_connection_cleanup_and_state_transition	process_ble_connection_cleanup_and_state_transition.c
format_ble_connection_status_message	format_ble_connection_status_message.c
enqueue_ble_connection_request	enqueue_ble_connection_request.c
update_ble_connection_state_and_cleanup	update_ble_connection_state_and_cleanup.c
find_ble_characteristic_by_uuid	find_ble_characteristic_by_uuid.c
find_ble_service_by_uuid	find_ble_service_by_uuid.c
find_ble_descriptor_by_uuid	find_ble_descriptor_by_uuid.c
find_ble_attribute_by_handle	find_ble_attribute_by_handle.c
validate_ble_attribute_handle	validate_ble_attribute_handle.c
find_ble_characteristic_by_handle	find_ble_characteristic_by_handle.c
update_ble_connection_handle_counter	update_ble_connection_handle_counter.c
process_ble_service_discovery_and_handle_assignment	process_ble_service_discovery_and_handle_assignment.c
process_ble_characteristic_value_update	process_ble_characteristic_value_update.c
initialize_ble_characteristic_value_buffer	initialize_ble_characteristic_value_buffer.c
send_ble_error_response	send_ble_error_response.c
process_ble_descriptor_read_request	process_ble_descriptor_read_request.c
process_ble_descriptor_and_log	process_ble_descriptor_and_log.c
validate_and_process_ble_descriptor	validate_and_process_ble_descriptor.c
create_and_configure_ble_descriptor	create_and_configure_ble_descriptor.c
dispatch_ble_characteristic_operation	dispatch_ble_characteristic_operation.c
format_ble_log_message_16byte	format_ble_log_message_16byte.c
execute_ble_log_message_callback	execute_ble_log_message_callback.c
initialize_ble_connection_data	initialize_ble_connection_data.c
manage_ble_connection_state_and_cleanup	manage_ble_connection_state_and_cleanup.c
handle_ble_attribute_value_change	handle_ble_attribute_value_change.c
initialize_ble_attribute_data	initialize_ble_attribute_data.c
update_ble_attribute_handle_range	update_ble_attribute_handle_range.c
update_ble_attribute_permissions_and_data	update_ble_attribute_permissions_and_data.c
cleanup_and_validate_ble_connections	cleanup_and_validate_ble_connections.c
setup_ble_configuration_and_connection	setup_ble_configuration_and_connection.c
log_ble_characteristic_status	log_ble_characteristic_status.c
check_and_log_ble_characteristic_status	check_and_log_ble_characteristic_status.c
enqueue_ble_connection_request	enqueue_ble_connection_request.c
map_ble_handle_to_index	map_ble_handle_to_index.c
process_ble_handle_mapping_comprehensive	process_ble_handle_mapping_comprehensive.c
derive_and_process_crypto_keys	derive_and_process_crypto_keys.c
manage_ble_attribute_and_crypto_state	manage_ble_attribute_and_crypto_state.c
ble_config_data_processor	ble_config_data_processor.c
ble_handle_mapping_processor	ble_handle_mapping_processor.c
ble_attribute_validation_handler	ble_attribute_validation_handler.c
ble_characteristic_value_change_handler	ble_characteristic_value_change_handler.c
ble_service_discovery_handler	ble_service_discovery_handler.c
ble_descriptor_discovery_handler	ble_descriptor_discovery_handler.c
handle_ble_characteristic_write_request	handle_ble_characteristic_write_request.c
process_ble_characteristic_write_operation	process_ble_characteristic_write_operation.c
dispatch_ble_characteristic_operation	dispatch_ble_characteristic_operation.c
FUN_0005b9cc	FUN_0005b9cc.c
process_ble_characteristic_operation_by_type	process_ble_characteristic_operation_by_type.c
process_ble_data_packet_by_format	process_ble_data_packet_by_format.c
format_ble_response_data	format_ble_response_data.c
process_ble_data_stream_by_format	process_ble_data_stream_by_format.c
handle_ble_characteristic_read_request	handle_ble_characteristic_read_request.c
initialize_ble_attribute_data_structure	initialize_ble_attribute_data_structure.c
manage_ble_attribute_data_operations	manage_ble_attribute_data_operations.c
process_ble_attribute_data_in_chunks	process_ble_attribute_data_in_chunks.c
process_ble_handle_mapping_and_log	process_ble_handle_mapping_and_log.c
handle_ble_characteristic_discovery	handle_ble_characteristic_discovery.c
handle_ble_descriptor_discovery	handle_ble_descriptor_discovery.c
process_ble_data_with_processing	process_ble_data_with_processing.c
check_ble_connection_state	check_ble_connection_state.c
analyze_ble_connection_state	analyze_ble_connection_state.c
update_ble_connection_state_with_error_handling	update_ble_connection_state_with_error_handling.c
handle_ble_error_and_log	handle_ble_error_and_log.c
validate_and_process_ble_characteristics_comprehensive	validate_and_process_ble_characteristics_comprehensive.c
process_ble_characteristics_with_validation	process_ble_characteristics_with_validation.c
process_ble_authentication_operation	process_ble_authentication_operation.c
process_ble_pairing_comprehensive	process_ble_pairing_comprehensive.c
process_ble_key_derivation	process_ble_key_derivation.c
calculate_ble_permissions_based_on_state	calculate_ble_permissions_based_on_state.c
process_ble_characteristic_operation_comprehensive	process_ble_characteristic_operation_comprehensive.c
validate_ble_attribute_permissions	validate_ble_attribute_permissions.c
handle_ble_connection_state_change	handle_ble_connection_state_change.c
update_ble_connection_parameters	update_ble_connection_parameters.c
validate_and_process_ble_connection_parameters	validate_and_process_ble_connection_parameters.c
setup_ble_connection_with_privacy_management	setup_ble_connection_with_privacy_management.c
complete_ble_connection_setup	complete_ble_connection_setup.c
handle_ble_connection_event	handle_ble_connection_event.c
manage_ble_connection_security	manage_ble_connection_security.c
handle_ble_connection_error	handle_ble_connection_error.c
initialize_ble_attribute_with_properties	initialize_ble_attribute_with_properties.c
validate_ble_characteristics_and_process	validate_ble_characteristics_and_process.c
manage_ble_attribute_table	manage_ble_attribute_table.c
initialize_ble_attribute	initialize_ble_attribute.c
handle_ble_attribute_callbacks	handle_ble_attribute_callbacks.c
handle_ble_attribute_properties	handle_ble_attribute_properties.c
find_ble_attribute_by_properties	find_ble_attribute_by_properties.c
find_ble_attribute_by_properties	find_ble_attribute_by_properties.c
find_ble_uuid_in_table	find_ble_uuid_in_table.c
set_ble_attribute_property	set_ble_attribute_property.c
create_ble_attribute_with_properties	create_ble_attribute_with_properties.c
cleanup_ble_attribute	cleanup_ble_attribute.c
process_ble_configuration_data	process_ble_configuration_data.c
process_ble_attribute_data	process_ble_attribute_data.c
safe_memory_copy_with_overlap_handling	safe_memory_copy_with_overlap_handling.c
derive_ble_pairing_keys	derive_ble_pairing_keys.c
derive_ble_keys_with_sha256	derive_ble_keys_with_sha256.c
calculate_ble_memory_offset	calculate_ble_memory_offset.c
calculate_ble_memory_size	calculate_ble_memory_size.c
initialize_ble_memory_structure	initialize_ble_memory_structure.c
process_ble_connection_data_with_framebuffer	process_ble_connection_data_with_framebuffer.c
add_ble_connection_to_list	add_ble_connection_to_list.c
remove_ble_connection_from_list	remove_ble_connection_from_list.c
initialize_debug_system_with_validation	initialize_debug_system_with_validation.c
decrement_reference_count_and_cleanup_memory	decrement_reference_count_and_cleanup_memory.c
increment_counter_in_structure	increment_counter_in_structure.c
find_last_element_in_linked_list	find_last_element_in_linked_list.c
merge_linked_lists	merge_linked_lists.c
append_linked_list_to_another	append_linked_list_to_another.c
remove_element_from_linked_list	remove_element_from_linked_list.c
process_ble_data_stream_in_chunks	process_ble_data_stream_in_chunks.c
calculate_buffer_offset	calculate_buffer_offset.c
update_buffer_size_and_offset	update_buffer_size_and_offset.c
update_buffer_position_and_size	update_buffer_position_and_size.c
update_buffer_position_and_size_alt	update_buffer_position_and_size_alt.c
ble_memory_allocation_utility	ble_memory_allocation_utility.c
apply_scaling_factor_from_lookup_table	apply_scaling_factor_from_lookup_table.c
initialize_device_configuration_flags	initialize_device_configuration_flags.c
configure_device_parameters_from_data	configure_device_parameters_from_data.c
manage_comprehensive_device_configuration	manage_comprehensive_device_configuration.c
check_device_status_and_handle_timing	check_device_status_and_handle_timing.c
validate_device_state_and_manage_tasks	validate_device_state_and_manage_tasks.c
handle_device_operation_by_code	handle_device_operation_by_code.c
configure_device	configure_device.c
handle_device_message_and_ble_connection	handle_device_message_and_ble_connection.c
handle_clock_control_operation	handle_clock_control_operation.c
dispatch_clock_control_callback	dispatch_clock_control_callback.c
initialize_device_components_and_states	initialize_device_components_and_states.c
calculate_device_address_by_index	calculate_device_address_by_index.c
manage_system_power_state_and_priorities	manage_system_power_state_and_priorities.c
lookup_device_property_from_table	lookup_device_property_from_table.c
set_device_property_and_log	set_device_property_and_log.c
handle_device_state_change	handle_device_state_change.c
check_device_capabilities_and_state	check_device_capabilities_and_state.c
initialize_device_and_ble_connection	initialize_device_and_ble_connection.c
validate_device_properties_and_state	validate_device_properties_and_state.c
manage_device_power_state_and_initialization	manage_device_power_state_and_initialization.c
handle_comprehensive_device_initialization	handle_comprehensive_device_initialization.c
manage_device_memory_and_state_changes	manage_device_memory_and_state_changes.c
write_device_memory_and_manage_states	write_device_memory_and_manage_states.c
read_device_memory_and_manage_states	read_device_memory_and_manage_states.c
handle_device_memory_alignment_and_ble	handle_device_memory_alignment_and_ble.c
write_device_memory_words_and_manage_ble	write_device_memory_words_and_manage_ble.c
reorder_linked_list_element	reorder_linked_list_element.c
handle_device_interrupt_and_state	handle_device_interrupt_and_state.c
configure_device_interrupt_settings	configure_device_interrupt_settings.c
manage_device_interrupt_enable_state	manage_device_interrupt_enable_state.c
trigger_device_interrupt	trigger_device_interrupt.c
validate_device_interrupt_state	validate_device_interrupt_state.c
validate_ble_connection_request_packet	validate_ble_connection_request_packet.c
manage_device_driver_states	manage_device_driver_states.c
handle_comprehensive_device_configuration	handle_comprehensive_device_configuration.c
handle_device_calibration_and_parameters	handle_device_calibration_and_parameters.c
handle_device_identification_and_validation	handle_device_identification_and_validation.c
configure_device_memory_parameters	configure_device_memory_parameters.c
handle_device_power_state_operations	handle_device_power_state_operations.c
initialize_device_components_comprehensive	initialize_device_components_comprehensive.c
handle_device_interrupt_with_privilege_control	handle_device_interrupt_with_privilege_control.c
handle_device_data_transmission	handle_device_data_transmission.c
handle_device_interrupt_comprehensive	handle_device_interrupt_comprehensive.c
control_timer_interrupt	control_timer_interrupt.c
enable_timer_interrupt	enable_timer_interrupt.c
configure_timer_interrupt_settings	configure_timer_interrupt_settings.c
manage_timer_interrupt_state	manage_timer_interrupt_state.c
get_timer_interrupt_value	get_timer_interrupt_value.c
get_high_resolution_timer	get_high_resolution_timer.c
manage_hardware_timer	manage_hardware_timer.c
handle_timer_interrupt_callback	handle_timer_interrupt_callback.c
manage_timer_interrupt_priority	manage_timer_interrupt_priority.c
set_timer_interrupt_flag	set_timer_interrupt_flag.c
schedule_ble_timer_event	schedule_ble_timer_event.c
initialize_timer_interrupt_settings	initialize_timer_interrupt_settings.c
configure_timer_interrupt_parameters	configure_timer_interrupt_parameters.c
manage_timer_interrupt_state_and_driver	manage_timer_interrupt_state_and_driver.c
handle_timer_interrupt_callback_execution	handle_timer_interrupt_callback_execution.c
handle_timer_interrupt_vector	handle_timer_interrupt_vector.c
handle_timer_interrupt_task_and_memory	handle_timer_interrupt_task_and_memory.c
dispatch_timer_interrupt_callbacks	dispatch_timer_interrupt_callbacks.c
process_timer_interrupt_callback_with_parameter	process_timer_interrupt_callback_with_parameter.c
manage_timer_interrupt_callback_dispatch	manage_timer_interrupt_callback_dispatch.c
manage_timer_interrupt_callback_state	manage_timer_interrupt_callback_state.c
execute_timer_interrupt_callback_with_validation	execute_timer_interrupt_callback_with_validation.c
process_timer_interrupt_data_with_validation	process_timer_interrupt_data_with_validation.c
validate_timer_interrupt_data_and_parameters	validate_timer_interrupt_data_and_parameters.c
process_timer_interrupt_data_loop_with_validation	process_timer_interrupt_data_loop_with_validation.c
lookup_timer_interrupt_data_from_table	lookup_timer_interrupt_data_from_table.c
process_timer_interrupt_data_by_type	process_timer_interrupt_data_by_type.c
parse_json_string_with_escape_sequences	parse_json_string_with_escape_sequences.c
format_json_string_with_escaping	format_json_string_with_escaping.c
duplicate_string_with_memory_allocation	duplicate_string_with_memory_allocation.c
set_json_object_field_with_memory_management	set_json_object_field_with_memory_management.c
format_json_value_by_type	format_json_value_by_type.c
format_json_value_with_memory_management	format_json_value_with_memory_management.c
cleanup_json_node	cleanup_json_node.c
parse_json_value_with_memory_allocation	parse_json_value_with_memory_allocation.c
create_json_boolean_value	create_json_boolean_value.c
create_json_string_value	create_json_string_value.c
create_json_array_value	create_json_array_value.c
create_json_obj	create_json_obj.c
process_bit_flags_and_return_value	process_bit_flags_and_return_value.c
FUN_00064ef8	FUN_00064ef8.c
FUN_00064f30	FUN_00064f30.c
FUN_00064f3c	FUN_00064f3c.c
FUN_00064f48	FUN_00064f48.c
FUN_00064f78	FUN_00064f78.c
FUN_00064fa8	FUN_00064fa8.c
FUN_00064fd4	FUN_00064fd4.c
FUN_00065190	FUN_00065190.c
FUN_000651d8	FUN_000651d8.c
FUN_00065324	FUN_00065324.c
FUN_0006540c	FUN_0006540c.c
FUN_00065418	FUN_00065418.c
FUN_00065434	FUN_00065434.c
FUN_00065448	FUN_00065448.c
FUN_00065460	FUN_00065460.c
FUN_00065478	FUN_00065478.c
FUN_00065494	FUN_00065494.c
FUN_000654ac	FUN_000654ac.c
FUN_000654c4	FUN_000654c4.c
FUN_00065504	FUN_00065504.c
FUN_00065584	FUN_00065584.c
FUN_000655ec	FUN_000655ec.c
FUN_00065620	FUN_00065620.c
FUN_0006567c	FUN_0006567c.c
FUN_000657e4	FUN_000657e4.c
FUN_000658dc	FUN_000658dc.c
FUN_000658e8	FUN_000658e8.c
FUN_00065940	FUN_00065940.c
FUN_000659b8	FUN_000659b8.c
FUN_000659cc	FUN_000659cc.c
FUN_000659d8	FUN_000659d8.c
FUN_000659e4	FUN_000659e4.c
FUN_00065acc	FUN_00065acc.c
FUN_00065b18	FUN_00065b18.c
FUN_00065b9c	FUN_00065b9c.c
FUN_00065d3c	FUN_00065d3c.c
FUN_00065d8c	FUN_00065d8c.c
FUN_00065e10	FUN_00065e10.c
FUN_00065e4c	FUN_00065e4c.c
FUN_00065ef0	FUN_00065ef0.c
FUN_00065f04	FUN_00065f04.c
FUN_00065f1c	FUN_00065f1c.c
FUN_00065f80	FUN_00065f80.c
FUN_00065ff4	FUN_00065ff4.c
FUN_00066050	FUN_00066050.c
FUN_00066130	FUN_00066130.c
FUN_0006615c	FUN_0006615c.c
FUN_000661dc	FUN_000661dc.c
FUN_00066214	FUN_00066214.c
FUN_00066270	FUN_00066270.c
FUN_00066300	FUN_00066300.c
FUN_00066478	FUN_00066478.c
FUN_0006649c	FUN_0006649c.c
FUN_000664f0	FUN_000664f0.c
FUN_00066644	FUN_00066644.c
FUN_0006666c	FUN_0006666c.c
FUN_000666e0	FUN_000666e0.c
FUN_00066720	FUN_00066720.c
FUN_00066784	FUN_00066784.c
FUN_000667e0	FUN_000667e0.c
FUN_00066850	FUN_00066850.c
FUN_00066994	FUN_00066994.c
FUN_000669f4	FUN_000669f4.c
FUN_00066ae0	FUN_00066ae0.c
FUN_00066b24	FUN_00066b24.c
FUN_00066bc4	FUN_00066bc4.c
FUN_00066c88	FUN_00066c88.c
FUN_00066d1c	FUN_00066d1c.c
FUN_00066d78	FUN_00066d78.c
FUN_00066e70	FUN_00066e70.c
FUN_00066ec0	FUN_00066ec0.c
FUN_00067138	FUN_00067138.c
FUN_000671d8	FUN_000671d8.c
FUN_00067248	FUN_00067248.c
FUN_00067304	FUN_00067304.c
FUN_00067548	FUN_00067548.c
FUN_000675c0	FUN_000675c0.c
FUN_00067600	FUN_00067600.c
FUN_00067794	FUN_00067794.c
FUN_00067884	FUN_00067884.c
FUN_000678d0	FUN_000678d0.c
FUN_00067938	FUN_00067938.c
FUN_00067d84	FUN_00067d84.c
FUN_00067dfc	FUN_00067dfc.c
FUN_00067e30	FUN_00067e30.c
FUN_00067e8c	FUN_00067e8c.c
FUN_00067f1c	FUN_00067f1c.c
FUN_00068134	FUN_00068134.c
FUN_00068170	FUN_00068170.c
FUN_000681cc	FUN_000681cc.c
FUN_00068204	FUN_00068204.c
FUN_00068240	FUN_00068240.c
FUN_00068280	FUN_00068280.c
FUN_000682a8	FUN_000682a8.c
FUN_000682f0	FUN_000682f0.c
FUN_000684a8	FUN_000684a8.c
FUN_00068590	FUN_00068590.c
FUN_000685f4	FUN_000685f4.c
FUN_00068908	FUN_00068908.c
FUN_0006897c	FUN_0006897c.c
FUN_00068a10	FUN_00068a10.c
FUN_00068b14	FUN_00068b14.c
FUN_00068b2c	FUN_00068b2c.c
FUN_00068b68	FUN_00068b68.c
FUN_00068d2c	FUN_00068d2c.c
FUN_00068d90	FUN_00068d90.c
FUN_00068de8	FUN_00068de8.c
FUN_00068e40	FUN_00068e40.c
FUN_00068ecc	FUN_00068ecc.c
FUN_00068f94	FUN_00068f94.c
FUN_00069238	FUN_00069238.c
FUN_00069468	FUN_00069468.c
FUN_0006954c	FUN_0006954c.c
FUN_000698d0	FUN_000698d0.c
FUN_0006a700	FUN_0006a700.c
FUN_0006aa98	FUN_0006aa98.c
FUN_0006ab80	FUN_0006ab80.c
FUN_0006b364	FUN_0006b364.c
FUN_0006b36c	FUN_0006b36c.c
FUN_0006b378	FUN_0006b378.c
FUN_0006b3c8	FUN_0006b3c8.c
FUN_0006b9b8	FUN_0006b9b8.c
FUN_0006bd74	FUN_0006bd74.c
FUN_0006bfc8	FUN_0006bfc8.c
FUN_0006c778	FUN_0006c778.c
FUN_0006efd8	FUN_0006efd8.c
FUN_0006efdc	FUN_0006efdc.c
FUN_0006f164	FUN_0006f164.c
FUN_0006f28c	FUN_0006f28c.c
FUN_0006f4a0	FUN_0006f4a0.c
FUN_0006f91c	FUN_0006f91c.c
FUN_0006f9c0	FUN_0006f9c0.c
FUN_0006ffd8	FUN_0006ffd8.c
FUN_000709d8	FUN_000709d8.c
FUN_00070b38	FUN_00070b38.c
FUN_00070e28	FUN_00070e28.c
initialize_microphone_with_callback	initialize_microphone_with_callback.c
FUN_00070f1c	FUN_00070f1c.c
FUN_00070f48	FUN_00070f48.c
FUN_00070f74	FUN_00070f74.c
FUN_00070fb4	FUN_00070fb4.c
FUN_000710b4	FUN_000710b4.c
FUN_0007118c	FUN_0007118c.c
FUN_00071294	FUN_00071294.c
FUN_00071314	FUN_00071314.c
FUN_00071358	FUN_00071358.c
FUN_0007158c	FUN_0007158c.c
FUN_00071678	FUN_00071678.c
FUN_00071684	FUN_00071684.c
manage_ble_memory_with_display_integration	manage_ble_memory_with_display_integration.c
process_ble_connection_data	process_ble_connection_data.c
enqueue_message_to_priority_queue	enqueue_message_to_priority_queue.c
initialize_ble_connection_structure	initialize_ble_connection_structure.c
initialize_ble_connection_with_timeout	initialize_ble_connection_with_timeout.c
process_ble_connection_batch	process_ble_connection_batch.c
check_connection_state_validity	check_connection_state_validity.c
validate_and_clear_connection_state	validate_and_clear_connection_state.c
update_connection_state_flags	update_connection_state_flags.c
enqueue_message_to_queue	enqueue_message_to_queue.c
FUN_00072240	FUN_00072240.c
resource_mutex_acquire	resource_mutex_acquire.c
mutex_unlock	mutex_unlock.c
FUN_00072674	FUN_00072674.c
FUN_000727ac	FUN_000727ac.c
z_spin_lock_valid	z_spin_lock_valid.c
manage_ble_connection_state_comprehensive	manage_ble_connection_state_comprehensive.c
FUN_000729fc	FUN_000729fc.c
FUN_00072c98	FUN_00072c98.c
FUN_00072cd4	FUN_00072cd4.c
FUN_00072e50	FUN_00072e50.c
FUN_00072e9c	FUN_00072e9c.c
FUN_00072f28	FUN_00072f28.c
FUN_00072fdc	FUN_00072fdc.c
FUN_00072fe8	FUN_00072fe8.c
FUN_000730b4	FUN_000730b4.c
FUN_000730e8	FUN_000730e8.c
FUN_000731b8	FUN_000731b8.c
FUN_000732d4	FUN_000732d4.c
FUN_00073418	FUN_00073418.c
FUN_0007350c	FUN_0007350c.c
acquire_mutex_with_priority_control	acquire_mutex_with_priority_control.c
FUN_000735cc	FUN_000735cc.c
check_ble_connection_state_valid	check_ble_connection_state_valid.c
handle_ble_connection_timeout	handle_ble_connection_timeout.c
manage_ble_connection_priority	manage_ble_connection_priority.c
insert_ble_connection_by_priority	insert_ble_connection_by_priority.c
FUN_000738d4	FUN_000738d4.c
FUN_00073960	FUN_00073960.c
validate_ble_connection_state_with_priority	validate_ble_connection_state_with_priority.c
update_ble_connection_state_flags	update_ble_connection_state_flags.c
process_ble_connection_state	process_ble_connection_state.c
finalize_ble_connection_with_magnetometer	finalize_ble_connection_with_magnetometer.c
remove_ble_connection_from_list	remove_ble_connection_from_list.c
reorder_ble_connection_by_priority	reorder_ble_connection_by_priority.c
validate_ble_connection_state	validate_ble_connection_state.c
manage_ble_connection_list	manage_ble_connection_list.c
update_ble_connection_parameters	update_ble_connection_parameters.c
handle_ble_connection_state_transition	handle_ble_connection_state_transition.c
update_ble_connection_priority	update_ble_connection_priority.c
cleanup_ble_connection_with_magnetometer	cleanup_ble_connection_with_magnetometer.c
remove_ble_connection_from_active_list	remove_ble_connection_from_active_list.c
cleanup_ble_connection_state_complete	cleanup_ble_connection_state_complete.c
process_ble_connection_list	process_ble_connection_list.c
process_ble_connection_list_with_cleanup	process_ble_connection_list_with_cleanup.c
update_ble_connection_priority_with_magnetometer	update_ble_connection_priority_with_magnetometer.c
manage_ble_connection_priority_with_data_processing	manage_ble_connection_priority_with_data_processing.c
integrate_ble_connection_with_touch_sensor	integrate_ble_connection_with_touch_sensor.c
calculate_ble_schedule_timing	calculate_ble_schedule_timing.c
process_ble_data_with_callback_validation	process_ble_data_with_callback_validation.c
process_ble_connection_data_with_priority	process_ble_connection_data_with_priority.c
handle_ble_connection_state_transition_with_data	handle_ble_connection_state_transition_with_data.c
get_ble_timing_offset	get_ble_timing_offset.c
calculate_ble_timeout_delay_with_validation	calculate_ble_timeout_delay_with_validation.c
remove_ble_connection_from_active_list_safe	remove_ble_connection_from_active_list_safe.c
schedule_ble_connection_timeout_with_priority	schedule_ble_connection_timeout_with_priority.c
cleanup_ble_connection_state_with_validation	cleanup_ble_connection_state_with_validation.c
calculate_ble_connection_timing_with_validation	calculate_ble_connection_timing_with_validation.c
schedule_dashboard_lock_task_with_ble_integration	schedule_dashboard_lock_task_with_ble_integration.c
process_ble_connection_states_with_bitmap_handling	process_ble_connection_states_with_bitmap_handling.c
cleanup_ble_connection_states_comprehensive	cleanup_ble_connection_states_comprehensive.c
set_ble_connection_state_flags_with_validation	set_ble_connection_state_flags_with_validation.c
process_ble_connection_states_with_transition_handling	process_ble_connection_states_with_transition_handling.c
manage_ble_connection_list_with_image_processing	manage_ble_connection_list_with_image_processing.c
allocate_ble_memory_with_alignment_and_validation	allocate_ble_memory_with_alignment_and_validation.c
classify_float_number	classify_float_number.c
normalize_float_number	normalize_float_number.c
scale_float_number	scale_float_number.c
handle_complex_mathematical_function	handle_complex_mathematical_function.c
handle_audio_mixing_with_validation	handle_audio_mixing_with_validation.c
handle_voltage_regulation_with_validation	handle_voltage_regulation_with_validation.c
handle_mathematical_function_with_validation	handle_mathematical_function_with_validation.c
handle_power_management_with_validation	handle_power_management_with_validation.c
calculate_mathematical_function_with_audio_power_integration	calculate_mathematical_function_with_audio_power_integration.c
calculate_division_with_audio_integration	calculate_division_with_audio_integration.c
calculate_mathematical_function_with_range_validation	calculate_mathematical_function_with_range_validation.c
calculate_logarithm_function	calculate_logarithm_function.c
calculate_natural_logarithm_function	calculate_natural_logarithm_function.c
calculate_mathematical_function_with_64bit_float_operations	calculate_mathematical_function_with_64bit_float_operations.c
calculate_arctangent_function	calculate_arctangent_function.c
process_data_loop_with_validation_and_retry	process_data_loop_with_validation_and_retry.c
process_buffer_with_mutex_and_validation	process_buffer_with_mutex_and_validation.c
configure_buffer_parameters_with_memory_initialization	configure_buffer_parameters_with_memory_initialization.c
acquire_buffer_allocation_mutex	acquire_buffer_allocation_mutex.c
release_buffer_allocation_mutex	release_buffer_allocation_mutex.c
acquire_buffer_mutex	acquire_buffer_mutex.c
initialize_buffer_structure_with_mutex_protection	initialize_buffer_structure_with_mutex_protection.c
allocate_buffer_block_with_mutex_protection	allocate_buffer_block_with_mutex_protection.c
handle_printf_format_string	handle_printf_format_string.c
handle_buffer_status_and_memory_allocation	handle_buffer_status_and_memory_allocation.c
malloc_maybe	malloc_maybe.c
call_data_verification_handler_with_memory_cleanup	call_data_verification_handler_with_memory_cleanup.c
memory_free_with_mutex_protection	memory_free_with_mutex_protection.c
memory_allocate_with_mutex_protection	memory_allocate_with_mutex_protection.c
printf_format_string_processor	printf_format_string_processor.c
format_float_for_printf_with_precision	format_float_for_printf_with_precision.c
format_integer_for_printf_with_padding	format_integer_for_printf_with_padding.c
printf_format_string_with_buffer_integration	printf_format_string_with_buffer_integration.c
calculate_string_length_with_buffer_processing	calculate_string_length_with_buffer_processing.c
memory_allocate_wrapper_with_error_handling	memory_allocate_wrapper_with_error_handling.c
process_string_with_error_handling_and_validation	process_string_with_error_handling_and_validation.c
process_string_with_maximum_value_handling	process_string_with_maximum_value_handling.c
process_string_with_length_calculation_and_validation	process_string_with_length_calculation_and_validation.c
FUN_00077a10	FUN_00077a10.c
convert_string_to_number_with_base_detection	convert_string_to_number_with_base_detection.c
printf_format_string_wrapper	printf_format_string_wrapper.c
process_string_with_maximum_value_and_validation	process_string_with_maximum_value_and_validation.c
handle_buffer_status_with_memory_allocation_and_validation	handle_buffer_status_with_memory_allocation_and_validation.c
init_float_context_with_error_handling	init_float_context_with_error_handling.c
process_buffer_with_complex_memory_management	process_buffer_with_complex_memory_management.c
format_float_with_precision_and_rounding	format_float_with_precision_and_rounding.c
check_precision_with_error_handling	check_precision_with_error_handling.c
get_format_string_data_pointer	get_format_string_data_pointer.c
execute_resource_function_with_error_handling	execute_resource_function_with_error_handling.c
acquire_memory_mutex_simple	acquire_memory_mutex_simple.c
release_memory_mutex	release_memory_mutex.c
manage_float_context_with_memory_allocation	manage_float_context_with_memory_allocation.c
cleanup_float_context_with_memory_management	cleanup_float_context_with_memory_management.c
multiply_float_with_memory_management	multiply_float_with_memory_management.c
calculate_float_power_with_memory_management	calculate_float_power_with_memory_management.c
initialize_float_context_simple	initialize_float_context_simple.c
multiply_float_complex_with_memory_management	multiply_float_complex_with_memory_management.c
calculate_float_power_optimized_with_memory_management	calculate_float_power_optimized_with_memory_management.c
shift_float_left_with_memory_management	shift_float_left_with_memory_management.c
subtract_float_with_memory_management	subtract_float_with_memory_management.c
normalize_float_value_with_exponent_handling	normalize_float_value_with_exponent_handling.c
process_float_formatting_with_precision	process_float_formatting_with_precision.c
convert_float_with_special_case_handling	convert_float_with_special_case_handling.c
process_printf_format_comprehensive	process_printf_format_comprehensive.c
parse_format_string_comprehensive	parse_format_string_comprehensive.c
process_string_format_with_validation	process_string_format_with_validation.c
format_float_digits_with_validation	format_float_digits_with_validation.c
execute_resource_function_with_mutex_protection	execute_resource_function_with_mutex_protection.c
check_system_status_with_fallback_handling	check_system_status_with_fallback_handling.c
initialize_memory_with_jump_table_handling	initialize_memory_with_jump_table_handling.c
initialize_system_with_validation_and_cleanup	initialize_system_with_validation_and_cleanup.c
check_system_status_with_parameter_validation	check_system_status_with_parameter_validation.c
validate_system_state_with_callback_handling	validate_system_state_with_callback_handling.c
initialize_system_state_with_memory_setup	initialize_system_state_with_memory_setup.c
handle_system_state_transition_with_callback_execution	handle_system_state_transition_with_callback_execution.c
clear_memory_buffer_with_size_validation	clear_memory_buffer_with_size_validation.c
FUN_00079808	FUN_00079808.c
calculate_sha256_hash_with_padding_and_processing	calculate_sha256_hash_with_padding_and_processing.c
process_sha256_block_with_counter_increment	process_sha256_block_with_counter_increment.c
update_sha256_hash_with_buffer_management	update_sha256_hash_with_buffer_management.c
initialize_sha256_context_with_default_values	initialize_sha256_context_with_default_values.c
finalize_sha256_hash_with_key_derivation	finalize_sha256_hash_with_key_derivation.c
derive_sha256_key_with_counter_management	derive_sha256_key_with_counter_management.c
reset_sha256_context_with_parameter_handling	reset_sha256_context_with_parameter_handling.c
validate_sha256_context_with_error_handling	validate_sha256_context_with_error_handling.c
initialize_cryptographic_context_with_parameter_setup	initialize_cryptographic_context_with_parameter_setup.c
generate_cryptographic_key_with_validation	generate_cryptographic_key_with_validation.c
initialize_system_with_cryptographic_setup	initialize_system_with_cryptographic_setup.c
main_system_initialization_with_error_handling	main_system_initialization_with_error_handling.c
FUN_0007a28c	FUN_0007a28c.c
set_system_parameter_with_validation	set_system_parameter_with_validation.c
set_system_parameter_simple	set_system_parameter_simple.c
wait_for_system_status_with_flag_checking	wait_for_system_status_with_flag_checking.c
check_system_status_with_flag_management	check_system_status_with_flag_management.c
initialize_system_components_with_dependency_management	initialize_system_components_with_dependency_management.c
cleanup_system_components_comprehensive	cleanup_system_components_comprehensive.c
system_initialization_stub_function	system_initialization_stub_function.c
copy_memory_safe	copy_memory_safe.c
fill_memory_buffer_utility	fill_memory_buffer_utility.c
FUN_0007a3d4	FUN_0007a3d4.c
execute_function_pointer_with_error_handling	execute_function_pointer_with_error_handling.c
execute_double_indirect_function_pointer	execute_double_indirect_function_pointer.c
execute_function_pointer_with_jump_table	execute_function_pointer_with_jump_table.c
execute_function_pointer_with_offset_handling	execute_function_pointer_with_offset_handling.c
handle_system_event_with_function_pointer_execution	handle_system_event_with_function_pointer_execution.c
manage_system_reference_counter_with_state_transitions	manage_system_reference_counter_with_state_transitions.c
configure_system_with_parameter_validation_and_state_management	configure_system_with_parameter_validation_and_state_management.c
analyze_bit_pattern_with_sequence_detection	analyze_bit_pattern_with_sequence_detection.c
analyze_bit_pattern_with_threshold_validation	analyze_bit_pattern_with_threshold_validation.c
manage_system_configuration_with_bit_pattern_analysis	manage_system_configuration_with_bit_pattern_analysis.c
wrapper_system_configuration_management	wrapper_system_configuration_management.c
initialize_system_configuration_with_parameter_setup	initialize_system_configuration_with_parameter_setup.c
process_system_data_with_memory_management_and_error_handling	process_system_data_with_memory_management_and_error_handling.c
initialize_sha256_context_with_error_handling	initialize_sha256_context_with_error_handling.c
cleanup_sha256_context_with_memory_clearing	cleanup_sha256_context_with_memory_clearing.c
initialize_sha256_key_with_size_validation	initialize_sha256_key_with_size_validation.c
process_sha256_hmac_with_validation	process_sha256_hmac_with_validation.c
reset_sha256_context_with_error_handling	reset_sha256_context_with_error_handling.c
FUN_0007abe8	FUN_0007abe8.c
set_sha256_context_parameter_with_validation	set_sha256_context_parameter_with_validation.c
update_sha256_data_with_buffer_management	update_sha256_data_with_buffer_management.c
extract_sha256_hash_result_with_type_validation	extract_sha256_hash_result_with_type_validation.c
initialize_sha256_context_parameter_with_memory_setup	initialize_sha256_context_parameter_with_memory_setup.c
finalize_sha256_hash_with_padding_and_processing	finalize_sha256_hash_with_padding_and_processing.c
update_sha256_data_with_block_processing	update_sha256_data_with_block_processing.c
calculate_sha256_hash_with_integrated_context_management	calculate_sha256_hash_with_integrated_context_management.c
validate_sha256_context_with_state_checking	validate_sha256_context_with_state_checking.c
initialize_sha256_constants_with_fallback_values	initialize_sha256_constants_with_fallback_values.c
FUN_0007b098	FUN_0007b098.c
select_sha256_parameter_with_switch_logic	select_sha256_parameter_with_switch_logic.c
validate_sha256_parameter_with_bit_manipulation	validate_sha256_parameter_with_bit_manipulation.c
reset_sha256_context_state_with_system_parameter_updates	reset_sha256_context_state_with_system_parameter_updates.c
process_sha256_block_with_parameter_management	process_sha256_block_with_parameter_management.c
initialize_sha256_key_with_type_based_memory_copying	initialize_sha256_key_with_type_based_memory_copying.c
process_sha256_context_with_system_integration	process_sha256_context_with_system_integration.c
reverse_sha256_byte_order_with_comprehensive_word_processing	reverse_sha256_byte_order_with_comprehensive_word_processing.c
validate_sha256_parameters_with_complex_state_checking	validate_sha256_parameters_with_complex_state_checking.c
initialize_sha256_state_with_type_based_processing	initialize_sha256_state_with_type_based_processing.c
copy_sha256_state_with_memory_operations	copy_sha256_state_with_memory_operations.c
process_sha256_context_with_comprehensive_state_management	process_sha256_context_with_comprehensive_state_management.c
process_sha256_context_with_special_case_handling	process_sha256_context_with_special_case_handling.c
FUN_0007bbcc	FUN_0007bbcc.c
validate_sha256_parameter_with_size_checking	validate_sha256_parameter_with_size_checking.c
FUN_0007bc24	FUN_0007bc24.c
FUN_0007be24	FUN_0007be24.c
FUN_0007bf44	FUN_0007bf44.c
FUN_0007c004	FUN_0007c004.c
z_spin_lock_valid	z_spin_lock_valid.c
FUN_0007c014	FUN_0007c014.c
FUN_0007c030	FUN_0007c030.c
FUN_0007c038	FUN_0007c038.c
debug_hook_before_flash_read	debug_hook_before_flash_read.c
debug_hook_flash_driver_not_ready	debug_hook_flash_driver_not_ready.c
FUN_0007c08e	FUN_0007c08e.c
calculate_ble_schedule_timing	calculate_ble_schedule_timing.c
FUN_0007c0a8	FUN_0007c0a8.c
FUN_0007c0c8	FUN_0007c0c8.c
FUN_0007c0e2	FUN_0007c0e2.c
update_work_mode_state	update_work_mode_state.c
FUN_0007c132	FUN_0007c132.c
z_spin_lock_valid	z_spin_lock_valid.c
set_work_mode_flags	set_work_mode_flags.c
get_current_time_ms	get_current_time_ms.c
copy_to_work_mode_buffer	copy_to_work_mode_buffer.c
set_work_mode_status	set_work_mode_status.c
FUN_0007c1fe	FUN_0007c1fe.c
FUN_0007c20a	FUN_0007c20a.c
process_ble_post_request	process_ble_post_request.c
FUN_0007c26e	FUN_0007c26e.c
FUN_0007c28e	FUN_0007c28e.c
FUN_0007c34a	FUN_0007c34a.c
FUN_0007c360	FUN_0007c360.c
calculate_ble_connection_timing_with_validation	calculate_ble_connection_timing_with_validation.c
FUN_0007c3c2	FUN_0007c3c2.c
FUN_0007c3d0	FUN_0007c3d0.c
FUN_0007c3da	FUN_0007c3da.c
FUN_0007c3ea	FUN_0007c3ea.c
FUN_0007c408	FUN_0007c408.c
FUN_0007c41c	FUN_0007c41c.c
FUN_0007c430	FUN_0007c430.c
FUN_0007c456	FUN_0007c456.c
FUN_0007c48a	FUN_0007c48a.c
FUN_0007c4b6	FUN_0007c4b6.c
FUN_0007c4f4	FUN_0007c4f4.c
FUN_0007c5ba	FUN_0007c5ba.c
FUN_0007c61e	FUN_0007c61e.c
FUN_0007c65c	FUN_0007c65c.c
FUN_0007c670	FUN_0007c670.c
FUN_0007c6a0	FUN_0007c6a0.c
FUN_0007c754	FUN_0007c754.c
FUN_0007c77e	FUN_0007c77e.c
FUN_0007c7de	FUN_0007c7de.c
FUN_0007c830	FUN_0007c830.c
FUN_0007c842	FUN_0007c842.c
FUN_0007c85e	FUN_0007c85e.c
resource_mutex_acquire	resource_mutex_acquire.c
mutex_unlock	mutex_unlock.c
FUN_0007c87a	FUN_0007c87a.c
FUN_0007c882	FUN_0007c882.c
FUN_0007c898	FUN_0007c898.c
FUN_0007c8b0	FUN_0007c8b0.c
FUN_0007c8c4	FUN_0007c8c4.c
FUN_0007c8d0	FUN_0007c8d0.c
FUN_0007c8e8	FUN_0007c8e8.c
FUN_0007c8fa	FUN_0007c8fa.c
FUN_0007c932	FUN_0007c932.c
FUN_0007c944	FUN_0007c944.c
FUN_0007c956	FUN_0007c956.c
FUN_0007c968	FUN_0007c968.c
FUN_0007c99e	FUN_0007c99e.c
FUN_0007c9f2	FUN_0007c9f2.c
FUN_0007c9fe	FUN_0007c9fe.c
FUN_0007ca18	FUN_0007ca18.c
FUN_0007ca24	FUN_0007ca24.c
FUN_0007ca4e	FUN_0007ca4e.c
FUN_0007ca54	FUN_0007ca54.c
calculate_ble_schedule_timing	calculate_ble_schedule_timing.c
FUN_0007ca80	FUN_0007ca80.c
FUN_0007cab4	FUN_0007cab4.c
FUN_0007cb2c	FUN_0007cb2c.c
manage_ble_connection_state_comprehensive	manage_ble_connection_state_comprehensive.c
z_spin_lock_valid	z_spin_lock_valid.c
manage_ble_connection_priority_with_data_processing	manage_ble_connection_priority_with_data_processing.c
FUN_0007cb54	FUN_0007cb54.c
FUN_0007cb66	FUN_0007cb66.c
calculate_ble_schedule_timing	calculate_ble_schedule_timing.c
delay_with_timing	delay_with_timing.c
FUN_0007cbae	FUN_0007cbae.c
handle_work_mode_finish	handle_work_mode_finish.c
render_panoramic_view	render_panoramic_view.c
update_task_status_and_clear_buffer	update_task_status_and_clear_buffer.c
z_spin_lock_valid	z_spin_lock_valid.c
short_timing_delay	short_timing_delay.c
is_panoramic_mode_active	is_panoramic_mode_active.c
get_high_resolution_timestamp	get_high_resolution_timestamp.c
calculate_ble_schedule_timing	calculate_ble_schedule_timing.c
clear_work_mode_flags_and_buffers	clear_work_mode_flags_and_buffers.c
FUN_0007ceda	FUN_0007ceda.c
FUN_0007cef6	FUN_0007cef6.c
FUN_0007cefc	FUN_0007cefc.c
FUN_0007cf34	FUN_0007cf34.c
FUN_0007cf70	FUN_0007cf70.c
FUN_0007cfac	FUN_0007cfac.c
FUN_0007cfdc	FUN_0007cfdc.c
FUN_0007d02a	FUN_0007d02a.c
FUN_0007d05e	FUN_0007d05e.c
FUN_0007d0aa	FUN_0007d0aa.c
FUN_0007d0e8	FUN_0007d0e8.c
FUN_0007d120	FUN_0007d120.c
FUN_0007d12e	FUN_0007d12e.c
delay_ms	delay_ms.c
FUN_0007d16a	FUN_0007d16a.c
FUN_0007d194	FUN_0007d194.c
FUN_0007d1b8	FUN_0007d1b8.c
dereference_pointer	dereference_pointer.c
FUN_0007d1d0	FUN_0007d1d0.c
FUN_0007d1d6	FUN_0007d1d6.c
FUN_0007d216	FUN_0007d216.c
get_work_mode_timestamp	get_work_mode_timestamp.c
FUN_0007d230	FUN_0007d230.c
FUN_0007d248	FUN_0007d248.c
FUN_0007d280	FUN_0007d280.c
FUN_0007d2d6	FUN_0007d2d6.c
FUN_0007d2d8	FUN_0007d2d8.c
FUN_0007d2f8	FUN_0007d2f8.c
FUN_0007d33a	FUN_0007d33a.c
FUN_0007d35a	FUN_0007d35a.c
resource_mutex_acquire	resource_mutex_acquire.c
mutex_unlock	mutex_unlock.c
FUN_0007d382	FUN_0007d382.c
FUN_0007d39e	FUN_0007d39e.c
reset_animation_counters	reset_animation_counters.c
FUN_0007d3c2	FUN_0007d3c2.c
gui_utf_adv_draw_configure	gui_utf_adv_draw_configure.c
get_ui_x_offset	get_ui_x_offset.c
get_ui_y_offset	get_ui_y_offset.c
FUN_0007d4b2	FUN_0007d4b2.c
jbd_get_manager	jbd_get_manager.c
FUN_0007d4f8	FUN_0007d4f8.c
draw_bitmap_to_framebuffer	draw_bitmap_to_framebuffer.c
draw_4bit_bitmap_to_framebuffer	draw_4bit_bitmap_to_framebuffer.c
FUN_0007d5f2	FUN_0007d5f2.c
thunk_FUN_0007d77c	thunk_FUN_0007d77c.c
jbd_spi_write_register	jbd_spi_write_register.c
FUN_0007d658	FUN_0007d658.c
FUN_0007d67e	FUN_0007d67e.c
jbd_spi_write_register	jbd_spi_write_register.c
FUN_0007d6ae	FUN_0007d6ae.c
FUN_0007d6f4	FUN_0007d6f4.c
FUN_0007d70a	FUN_0007d70a.c
FUN_0007d74e	FUN_0007d74e.c
FUN_0007d772	FUN_0007d772.c
FUN_0007d77c	FUN_0007d77c.c
jbd_spi_flash_write	jbd_spi_flash_write.c
jbd_spi_write_command	jbd_spi_write_command.c
get_ascii_bitmap_data	get_ascii_bitmap_data.c
FUN_0007d850	FUN_0007d850.c
FUN_0007d860	FUN_0007d860.c
FUN_0007d874	FUN_0007d874.c
FUN_0007d894	FUN_0007d894.c
FUN_0007d8c4	FUN_0007d8c4.c
FUN_0007d8f4	FUN_0007d8f4.c
FUN_0007d968	FUN_0007d968.c
get_system_timestamp_ms	get_system_timestamp_ms.c
FUN_0007d9c0	FUN_0007d9c0.c
FUN_0007da4a	FUN_0007da4a.c
FUN_0007da70	FUN_0007da70.c
FUN_0007daa4	FUN_0007daa4.c
FUN_0007dac0	FUN_0007dac0.c
FUN_0007dada	FUN_0007dada.c
FUN_0007db02	FUN_0007db02.c
FUN_0007db50	FUN_0007db50.c
FUN_0007db9e	FUN_0007db9e.c
FUN_0007dc00	FUN_0007dc00.c
FUN_0007dc4a	FUN_0007dc4a.c
FUN_0007dcb8	FUN_0007dcb8.c
mutex_unlock	mutex_unlock.c
FUN_0007dcda	FUN_0007dcda.c
FUN_0007dd0a	FUN_0007dd0a.c
FUN_0007dd7e	FUN_0007dd7e.c
DEBUG_PRINT	DEBUG_PRINT.c
format_string_with_variable_arguments	format_string_with_variable_arguments.c
FUN_0007ddec	FUN_0007ddec.c
set_heap_chunk_metadata	set_heap_chunk_metadata.c
FUN_0007de18	FUN_0007de18.c
set_heap_chunk_flags	set_heap_chunk_flags.c
set_heap_chunk_size	set_heap_chunk_size.c
FUN_0007de5c	FUN_0007de5c.c
calculate_heap_chunk_overhead	calculate_heap_chunk_overhead.c
calculate_heap_chunk_size	calculate_heap_chunk_size.c
FUN_0007de9a	FUN_0007de9a.c
FUN_0007def6	FUN_0007def6.c
FUN_0007df24	FUN_0007df24.c
FUN_0007df98	FUN_0007df98.c
FUN_0007dfe6	FUN_0007dfe6.c
link_heap_chunks	link_heap_chunks.c
FUN_0007e0a6	FUN_0007e0a6.c
FUN_0007e18e	FUN_0007e18e.c
FUN_0007e1c6	FUN_0007e1c6.c
FUN_0007e1e6	FUN_0007e1e6.c
FUN_0007e212	FUN_0007e212.c
FUN_0007e238	FUN_0007e238.c
FUN_0007e260	FUN_0007e260.c
FUN_0007e290	FUN_0007e290.c
FUN_0007e2be	FUN_0007e2be.c
assertion_failure	assertion_failure.c
DEBUG_PRINT2	DEBUG_PRINT2.c
FUN_0007e314	FUN_0007e314.c
FUN_0007e33a	FUN_0007e33a.c
FUN_0007e35c	FUN_0007e35c.c
FUN_0007e378	FUN_0007e378.c
FUN_0007e390	FUN_0007e390.c
FUN_0007e3ce	FUN_0007e3ce.c
FUN_0007e4bc	FUN_0007e4bc.c
FUN_0007e4f2	FUN_0007e4f2.c
FUN_0007e526	FUN_0007e526.c
FUN_0007e53e	FUN_0007e53e.c
FUN_0007e55a	FUN_0007e55a.c
FUN_0007e574	FUN_0007e574.c
FUN_0007e5c8	FUN_0007e5c8.c
FUN_0007e5da	FUN_0007e5da.c
FUN_0007e624	FUN_0007e624.c
FUN_0007e658	FUN_0007e658.c
FUN_0007e65e	FUN_0007e65e.c
FUN_0007e672	FUN_0007e672.c
FUN_0007e6a6	FUN_0007e6a6.c
FUN_0007e6e2	FUN_0007e6e2.c
FUN_0007e776	FUN_0007e776.c
FUN_0007e7ea	FUN_0007e7ea.c
FUN_0007e80c	FUN_0007e80c.c
FUN_0007e83a	FUN_0007e83a.c
FUN_0007e9d4	FUN_0007e9d4.c
FUN_0007e9dc	FUN_0007e9dc.c
FUN_0007e9ea	FUN_0007e9ea.c
FUN_0007ea64	FUN_0007ea64.c
FUN_0007eae4	FUN_0007eae4.c
mutex_unlock	mutex_unlock.c
FUN_0007eb4e	FUN_0007eb4e.c
FUN_0007eb5c	FUN_0007eb5c.c
FUN_0007eb7e	FUN_0007eb7e.c
FUN_0007ebee	FUN_0007ebee.c
FUN_0007ec0e	FUN_0007ec0e.c
FUN_0007ecc4	FUN_0007ecc4.c
FUN_0007ecf2	FUN_0007ecf2.c
FUN_0007ed2a	FUN_0007ed2a.c
FUN_0007ed88	FUN_0007ed88.c
FUN_0007eda4	FUN_0007eda4.c
increment_counter	increment_counter.c
FUN_0007ee44	FUN_0007ee44.c
FUN_0007ee48	FUN_0007ee48.c
bt_connection_data_processing_and_callback	bt_connection_data_processing_and_callback.c
FUN_0007eea6	FUN_0007eea6.c
FUN_0007eec0	FUN_0007eec0.c
FUN_0007eece	FUN_0007eece.c
FUN_0007ef04	FUN_0007ef04.c
FUN_0007ef1c	FUN_0007ef1c.c
FUN_0007ef2e	FUN_0007ef2e.c
FUN_0007ef3e	FUN_0007ef3e.c
FUN_0007ef6e	FUN_0007ef6e.c
FUN_0007ef7e	FUN_0007ef7e.c
FUN_0007ef80	FUN_0007ef80.c
FUN_0007efaa	FUN_0007efaa.c
FUN_0007efd4	FUN_0007efd4.c
FUN_0007f000	FUN_0007f000.c
FUN_0007f00e	FUN_0007f00e.c
FUN_0007f012	FUN_0007f012.c
FUN_0007f020	FUN_0007f020.c
FUN_0007f064	FUN_0007f064.c
FUN_0007f088	FUN_0007f088.c
FUN_0007f110	FUN_0007f110.c
FUN_0007f150	FUN_0007f150.c
FUN_0007f192	FUN_0007f192.c
FUN_0007f198	FUN_0007f198.c
compare_string_with_pattern	compare_string_with_pattern.c
parse_string_until_delimiter	parse_string_until_delimiter.c
FUN_0007f210	FUN_0007f210.c
FUN_0007f228	FUN_0007f228.c
FUN_0007f344	FUN_0007f344.c
FUN_0007f386	FUN_0007f386.c
FUN_0007f3c2	FUN_0007f3c2.c
FUN_0007f3f0	FUN_0007f3f0.c
FUN_0007f406	FUN_0007f406.c
FUN_0007f40c	FUN_0007f40c.c
FUN_0007f438	FUN_0007f438.c
FUN_0007f460	FUN_0007f460.c
FUN_0007f4a0	FUN_0007f4a0.c
FUN_0007f4c8	FUN_0007f4c8.c
FUN_0007f4cc	FUN_0007f4cc.c
FUN_0007f4d2	FUN_0007f4d2.c
FUN_0007f4d6	FUN_0007f4d6.c
FUN_0007f51a	FUN_0007f51a.c
FUN_0007f542	FUN_0007f542.c
FUN_0007f570	FUN_0007f570.c
FUN_0007f594	FUN_0007f594.c
FUN_0007f5d8	FUN_0007f5d8.c
FUN_0007f5ee	FUN_0007f5ee.c
FUN_0007f612	FUN_0007f612.c
FUN_0007f634	FUN_0007f634.c
FUN_0007f69e	FUN_0007f69e.c
FUN_0007f6b6	FUN_0007f6b6.c
FUN_0007f772	FUN_0007f772.c
FUN_0007f79e	FUN_0007f79e.c
thunk_FUN_0007f7d2	thunk_FUN_0007f7d2.c
FUN_0007f7c8	FUN_0007f7c8.c
FUN_0007f7d2	FUN_0007f7d2.c
FUN_0007f894	FUN_0007f894.c
FUN_0007f8c6	FUN_0007f8c6.c
FUN_0007f8dc	FUN_0007f8dc.c
initialize_microphone	initialize_microphone.c
FUN_0007f97c	FUN_0007f97c.c
FUN_0007f98a	FUN_0007f98a.c
FUN_0007f998	FUN_0007f998.c
FUN_0007f9c6	FUN_0007f9c6.c
FUN_0007f9f4	FUN_0007f9f4.c
FUN_0007fa22	FUN_0007fa22.c
FUN_0007fa7a	FUN_0007fa7a.c
FUN_0007faa8	FUN_0007faa8.c
FUN_0007fae4	FUN_0007fae4.c
FUN_0007fb20	FUN_0007fb20.c
FUN_0007fb3e	FUN_0007fb3e.c
FUN_0007fb4c	FUN_0007fb4c.c
FUN_0007fb7a	FUN_0007fb7a.c
FUN_0007fbd6	FUN_0007fbd6.c
FUN_0007fc04	FUN_0007fc04.c
FUN_0007fc2c	FUN_0007fc2c.c
FUN_0007fc72	FUN_0007fc72.c
FUN_0007fd4e	FUN_0007fd4e.c
FUN_0007fe2a	FUN_0007fe2a.c
FUN_0007fe72	FUN_0007fe72.c
FUN_0007feaa	FUN_0007feaa.c
fill_memory_buffer	fill_memory_buffer.c
FUN_0007fec8	FUN_0007fec8.c
FUN_0007feda	FUN_0007feda.c
FUN_0007ff64	FUN_0007ff64.c
FUN_0007ffd6	FUN_0007ffd6.c
sha256_finalize	sha256_finalize.c
aes_key_expansion	aes_key_expansion.c
sha256_init_context	sha256_init_context.c
sha256_reset_context	sha256_reset_context.c
derive_encryption_keys	derive_encryption_keys.c
sha256_update	sha256_update.c
sha256_finalize_and_reset	sha256_finalize_and_reset.c
process_crypto_stream	process_crypto_stream.c
sha256_finalize_block	sha256_finalize_block.c
prepare_hmac_keys	prepare_hmac_keys.c
hmac_sha256	hmac_sha256.c
hmac_inner_hash	hmac_inner_hash.c
hmac_outer_hash	hmac_outer_hash.c
hmac_finalize	hmac_finalize.c
pbkdf2_hmac_sha256	pbkdf2_hmac_sha256.c
init_key_derivation	init_key_derivation.c
derive_next_key_block	derive_next_key_block.c
derive_key_output	derive_key_output.c
float_to_string_ieee754	float_to_string_ieee754.c
extract_float_exponent	extract_float_exponent.c
process_float_mantissa	process_float_mantissa.c
is_precision_small	is_precision_small.c
init_float_context	init_float_context.c
thunk_FUN_00071678	thunk_FUN_00071678.c
convert_float_format	convert_float_format.c
init_data_structure	init_data_structure.c
update_data_structure	update_data_structure.c
process_command_table	process_command_table.c
call_system_cleanup	call_system_cleanup.c
compare_versions	compare_versions.c
call_with_parameters	call_with_parameters.c
process_state_machine	process_state_machine.c
validate_state_transition	validate_state_transition.c
no_operation	no_operation.c
no_operation_alt	no_operation_alt.c
shift_left_by_one	shift_left_by_one.c
return_zero	return_zero.c
validate_encryption_key	validate_encryption_key.c
clear_key_slot	clear_key_slot.c
process_data_loop	process_data_loop.c
decrement_reference_count_and_cleanup_memory	decrement_reference_count_and_cleanup_memory.c
transfer_data_with_callback	transfer_data_with_callback.c
cleanup_with_callback	cleanup_with_callback.c
init_data_fields	init_data_fields.c
get_data_status	get_data_status.c
manage_data_buffer	manage_data_buffer.c
flush_data_buffer	flush_data_buffer.c
get_buffer_data_ptr	get_buffer_data_ptr.c
reset_flags	reset_flags.c
validate_data_structure	validate_data_structure.c
manage_power_state	manage_power_state.c
calculate_offset	calculate_offset.c
validate_spin_lock_state	validate_spin_lock_state.c
validate_identifier	validate_identifier.c
parse_config_data	parse_config_data.c
return_zero_alt	return_zero_alt.c
compare_data_structures	compare_data_structures.c
format_data_by_size	format_data_by_size.c
init_status_structure	init_status_structure.c
map_value_category	map_value_category.c
determine_priority_level	determine_priority_level.c
set_bits	set_bits.c
copy_data_structure	copy_data_structure.c
call_system_cleanup_alt	call_system_cleanup_alt.c
FUN_00080ea8	FUN_00080ea8.c
convert_to_byte_format	convert_to_byte_format.c
FUN_00080ed8	FUN_00080ed8.c
FUN_00080f14	FUN_00080f14.c
FUN_00080f56	FUN_00080f56.c
FUN_00080f8c	FUN_00080f8c.c
FUN_00080f92	FUN_00080f92.c
FUN_00080fa4	FUN_00080fa4.c
FUN_00080fb4	FUN_00080fb4.c
FUN_00080fba	FUN_00080fba.c
FUN_00080fc4	FUN_00080fc4.c
FUN_00080fd2	FUN_00080fd2.c
FUN_0008104a	FUN_0008104a.c
FUN_00081050	FUN_00081050.c
FUN_00081080	FUN_00081080.c
FUN_000810da	FUN_000810da.c
FUN_000810f2	FUN_000810f2.c
FUN_00081102	FUN_00081102.c
FUN_00081130	FUN_00081130.c
FUN_00081158	FUN_00081158.c
FUN_0008115c	FUN_0008115c.c
FUN_0008117a	FUN_0008117a.c
FUN_00081180	FUN_00081180.c
FUN_00081196	FUN_00081196.c
FUN_000811a4	FUN_000811a4.c
FUN_000811ce	FUN_000811ce.c
FUN_000812b2	FUN_000812b2.c
FUN_000812d2	FUN_000812d2.c
FUN_00081320	FUN_00081320.c
FUN_00081326	FUN_00081326.c
FUN_0008137e	FUN_0008137e.c
bt_connection_update_flags	bt_connection_update_flags.c
bt_log_connection_error	bt_log_connection_error.c
FUN_000813d6	FUN_000813d6.c
FUN_000813e8	FUN_000813e8.c
FUN_0008142c	FUN_0008142c.c
FUN_0008144a	FUN_0008144a.c
check_ble_security_level	check_ble_security_level.c
FUN_0008148a	FUN_0008148a.c
FUN_0008149a	FUN_0008149a.c
get_ble_property_value	get_ble_property_value.c
ble_uuid_comparison_handler	ble_uuid_comparison_handler.c
get_connection_data_pointer	get_connection_data_pointer.c
FUN_0008152a	FUN_0008152a.c
FUN_0008157a	FUN_0008157a.c
FUN_000815f6	FUN_000815f6.c
FUN_00081616	FUN_00081616.c
FUN_00081626	FUN_00081626.c
FUN_00081660	FUN_00081660.c
FUN_000816a2	FUN_000816a2.c
FUN_00081720	FUN_00081720.c
FUN_00081746	FUN_00081746.c
FUN_0008174c	FUN_0008174c.c
FUN_00081788	FUN_00081788.c
bt_connection_cleanup_and_notify	bt_connection_cleanup_and_notify.c
bt_connection_update_state	bt_connection_update_state.c
FUN_0008181a	FUN_0008181a.c
FUN_00081820	FUN_00081820.c
FUN_00081852	FUN_00081852.c
FUN_000818dc	FUN_000818dc.c
FUN_00081940	FUN_00081940.c
FUN_00081962	FUN_00081962.c
FUN_0008199a	FUN_0008199a.c
FUN_000819ea	FUN_000819ea.c
FUN_00081a4e	FUN_00081a4e.c
FUN_00081a60	FUN_00081a60.c
FUN_00081a76	FUN_00081a76.c
FUN_00081aca	FUN_00081aca.c
FUN_00081adc	FUN_00081adc.c
FUN_00081b30	FUN_00081b30.c
FUN_00081bac	FUN_00081bac.c
FUN_00081bc0	FUN_00081bc0.c
FUN_00081bd0	FUN_00081bd0.c
FUN_00081bf0	FUN_00081bf0.c
FUN_00081c02	FUN_00081c02.c
FUN_00081c22	FUN_00081c22.c
FUN_00081c8c	FUN_00081c8c.c
FUN_00081cee	FUN_00081cee.c
FUN_00081d24	FUN_00081d24.c
FUN_00081ddc	FUN_00081ddc.c
FUN_00081de2	FUN_00081de2.c
FUN_00081e14	FUN_00081e14.c
FUN_00081e2a	FUN_00081e2a.c
FUN_00081fbe	FUN_00081fbe.c
FUN_00082030	FUN_00082030.c
FUN_0008206c	FUN_0008206c.c
FUN_000820ae	FUN_000820ae.c
FUN_00082114	FUN_00082114.c
FUN_000821a4	FUN_000821a4.c
FUN_000821c0	FUN_000821c0.c
FUN_000821f4	FUN_000821f4.c
FUN_00082236	FUN_00082236.c
FUN_00082258	FUN_00082258.c
FUN_00082282	FUN_00082282.c
FUN_000822ae	FUN_000822ae.c
FUN_000822bc	FUN_000822bc.c
FUN_000822fc	FUN_000822fc.c
FUN_00082326	FUN_00082326.c
FUN_00082346	FUN_00082346.c
FUN_00082366	FUN_00082366.c
FUN_00082396	FUN_00082396.c
FUN_000823fa	FUN_000823fa.c
FUN_0008253a	FUN_0008253a.c
FUN_0008256e	FUN_0008256e.c
FUN_00082572	FUN_00082572.c
FUN_00082594	FUN_00082594.c
update_ble_connection_state	update_ble_connection_state.c
update_ble_descriptor_value	update_ble_descriptor_value.c
FUN_000825d4	FUN_000825d4.c
FUN_0008260c	FUN_0008260c.c
FUN_000826b2	FUN_000826b2.c
FUN_000826c2	FUN_000826c2.c
FUN_000826e0	FUN_000826e0.c
FUN_000826f6	FUN_000826f6.c
get_ble_handle_value	get_ble_handle_value.c
FUN_00082712	FUN_00082712.c
FUN_0008275e	FUN_0008275e.c
FUN_00082772	FUN_00082772.c
FUN_0008278a	FUN_0008278a.c
FUN_0008279c	FUN_0008279c.c
FUN_000827ae	FUN_000827ae.c
FUN_000827de	FUN_000827de.c
FUN_0008281a	FUN_0008281a.c
FUN_00082856	FUN_00082856.c
FUN_000828da	FUN_000828da.c
FUN_000828e8	FUN_000828e8.c
FUN_00082928	FUN_00082928.c
FUN_00082932	FUN_00082932.c
FUN_0008295a	FUN_0008295a.c
FUN_00082988	FUN_00082988.c
FUN_000829c0	FUN_000829c0.c
FUN_000829f0	FUN_000829f0.c
FUN_00082a1a	FUN_00082a1a.c
ble_data_processing_wrapper	ble_data_processing_wrapper.c
FUN_00082ab8	FUN_00082ab8.c
FUN_00082aee	FUN_00082aee.c
FUN_00082b6e	FUN_00082b6e.c
FUN_00082b98	FUN_00082b98.c
FUN_00082bb8	FUN_00082bb8.c
FUN_00082bd4	FUN_00082bd4.c
map_ble_handle_to_index_with_validation	map_ble_handle_to_index_with_validation.c
FUN_00082c48	FUN_00082c48.c
ble_handle_mapping_utility	ble_handle_mapping_utility.c
thunk_FUN_000823fa	thunk_FUN_000823fa.c
ble_permission_access_validator	ble_permission_access_validator.c
FUN_00082d2e	FUN_00082d2e.c
FUN_00082d6a	FUN_00082d6a.c
FUN_00082e04	FUN_00082e04.c
FUN_00082e24	FUN_00082e24.c
FUN_00082e62	FUN_00082e62.c
FUN_00082ec8	FUN_00082ec8.c
FUN_00082f3a	FUN_00082f3a.c
FUN_00082fa6	FUN_00082fa6.c
FUN_00082fd2	FUN_00082fd2.c
FUN_00082ff6	FUN_00082ff6.c
FUN_00083002	FUN_00083002.c
FUN_0008304c	FUN_0008304c.c
FUN_00083062	FUN_00083062.c
FUN_00083074	FUN_00083074.c
FUN_0008307a	FUN_0008307a.c
FUN_00083090	FUN_00083090.c
FUN_000830a4	FUN_000830a4.c
FUN_000830b0	FUN_000830b0.c
FUN_000830ee	FUN_000830ee.c
FUN_000831be	FUN_000831be.c
FUN_000831e2	FUN_000831e2.c
FUN_00083204	FUN_00083204.c
FUN_0008323a	FUN_0008323a.c
FUN_000832f0	FUN_000832f0.c
FUN_00083370	FUN_00083370.c
FUN_00083496	FUN_00083496.c
FUN_0008349c	FUN_0008349c.c
FUN_0008352c	FUN_0008352c.c
reverse_byte_order	reverse_byte_order.c
sha256_hash_data	sha256_hash_data.c
ble_authentication_hash	ble_authentication_hash.c
derive_ble_long_term_keys	derive_ble_long_term_keys.c
lookup_timer_interrupt_data_from_table	lookup_timer_interrupt_data_from_table.c
FUN_000836d8	FUN_000836d8.c
FUN_000836de	FUN_000836de.c
thunk_FUN_000727ac	thunk_FUN_000727ac.c
FUN_000836ec	FUN_000836ec.c
write_ble_data_uint16	write_ble_data_uint16.c
write_ble_data_uint8	write_ble_data_uint8.c
read_ble_data_uint16	read_ble_data_uint16.c
FUN_00083728	FUN_00083728.c
calculate_ble_buffer_available_space	calculate_ble_buffer_available_space.c
ble_memory_copy_utility	ble_memory_copy_utility.c
write_ble_data_with_allocation	write_ble_data_with_allocation.c
write_ble_data_uint16_with_allocation	write_ble_data_uint16_with_allocation.c
decrement_ble_connection_reference	decrement_ble_connection_reference.c
FUN_000837a2	FUN_000837a2.c
FUN_000837c2	FUN_000837c2.c
ble_interrupt_handler_with_priority_control	ble_interrupt_handler_with_priority_control.c
FUN_00083848	FUN_00083848.c
FUN_00083896	FUN_00083896.c
FUN_000838d6	FUN_000838d6.c
FUN_000838dc	FUN_000838dc.c
set_ble_connection_state	set_ble_connection_state.c
FUN_00083906	FUN_00083906.c
FUN_0008392e	FUN_0008392e.c
FUN_00083954	FUN_00083954.c
FUN_0008397e	FUN_0008397e.c
FUN_000839a6	FUN_000839a6.c
FUN_000839dc	FUN_000839dc.c
FUN_000839fe	FUN_000839fe.c
FUN_00083a92	FUN_00083a92.c
get_driver_capabilities	get_driver_capabilities.c
FUN_00083ac2	FUN_00083ac2.c
FUN_00083b1a	FUN_00083b1a.c
FUN_00083b62	FUN_00083b62.c
FUN_00083ba6	FUN_00083ba6.c
FUN_00083bca	FUN_00083bca.c
FUN_00083bf0	FUN_00083bf0.c
FUN_00083cb4	FUN_00083cb4.c
FUN_00083cde	FUN_00083cde.c
FUN_00083cfc	FUN_00083cfc.c
FUN_00083d34	FUN_00083d34.c
FUN_00083d60	FUN_00083d60.c
FUN_00083d80	FUN_00083d80.c
FUN_00083dba	FUN_00083dba.c
FUN_00083dc8	FUN_00083dc8.c
FUN_00083de6	FUN_00083de6.c
FUN_00083e0e	FUN_00083e0e.c
FUN_00083e70	FUN_00083e70.c
FUN_00083eb8	FUN_00083eb8.c
FUN_00083ede	FUN_00083ede.c
FUN_00084068	FUN_00084068.c
FUN_00084090	FUN_00084090.c
FUN_000840cc	FUN_000840cc.c
FUN_000841fc	FUN_000841fc.c
FUN_000842cc	FUN_000842cc.c
FUN_00084300	FUN_00084300.c
FUN_00084348	FUN_00084348.c
FUN_000843ba	FUN_000843ba.c
FUN_00084418	FUN_00084418.c
FUN_000844a8	FUN_000844a8.c
FUN_000844e0	FUN_000844e0.c
FUN_00084516	FUN_00084516.c
FUN_00084602	FUN_00084602.c
FUN_00084774	FUN_00084774.c
FUN_000847d8	FUN_000847d8.c
FUN_00084840	FUN_00084840.c
FUN_0008484e	FUN_0008484e.c
FUN_00084880	FUN_00084880.c
FUN_000848b0	FUN_000848b0.c
FUN_000848d2	FUN_000848d2.c
FUN_0008493a	FUN_0008493a.c
FUN_0008496c	FUN_0008496c.c
FUN_000849da	FUN_000849da.c
FUN_00084a24	FUN_00084a24.c
FUN_00084a54	FUN_00084a54.c
FUN_00084abe	FUN_00084abe.c
FUN_00084ade	FUN_00084ade.c
FUN_00084b14	FUN_00084b14.c
FUN_00084b32	FUN_00084b32.c
FUN_00084b86	FUN_00084b86.c
FUN_00084c2c	FUN_00084c2c.c
reset_hardware_timer	reset_hardware_timer.c
FUN_00084c76	FUN_00084c76.c
FUN_00084c7e	FUN_00084c7e.c
FUN_00084c94	FUN_00084c94.c
FUN_00084cb0	FUN_00084cb0.c
FUN_00084cda	FUN_00084cda.c
FUN_00084cfa	FUN_00084cfa.c
FUN_00084d36	FUN_00084d36.c
FUN_00084d64	FUN_00084d64.c
FUN_00084d70	FUN_00084d70.c
FUN_00084d8c	FUN_00084d8c.c
FUN_00084db2	FUN_00084db2.c
FUN_00084dea	FUN_00084dea.c
FUN_00084e58	FUN_00084e58.c
FUN_00084e66	FUN_00084e66.c
FUN_00084e72	FUN_00084e72.c
FUN_00084e9a	FUN_00084e9a.c
FUN_00084ed8	FUN_00084ed8.c
FUN_00084f16	FUN_00084f16.c
FUN_00084f2e	FUN_00084f2e.c
FUN_00084f58	FUN_00084f58.c
json_alloc	json_alloc.c
FUN_00084fec	FUN_00084fec.c
FUN_0008500c	FUN_0008500c.c
FUN_00085014	FUN_00085014.c
FUN_0008501a	FUN_0008501a.c
FUN_00085020	FUN_00085020.c
FUN_00085030	FUN_00085030.c
FUN_0008503c	FUN_0008503c.c
thunk_FUN_00084f2e	thunk_FUN_00084f2e.c
add_json_named_object	add_json_named_object.c
FUN_0008504c	FUN_0008504c.c
add_json_field_simple	add_json_field_simple.c
add_json_field_complex	add_json_field_complex.c
FUN_000850c8	FUN_000850c8.c
thunk_FUN_00086384	thunk_FUN_00086384.c
FUN_000850dc	FUN_000850dc.c
FUN_000850f6	FUN_000850f6.c
FUN_0008511a	FUN_0008511a.c
FUN_00085130	FUN_00085130.c
FUN_000851ca	FUN_000851ca.c
FUN_000851e8	FUN_000851e8.c
FUN_000851ee	FUN_000851ee.c
FUN_000851f4	FUN_000851f4.c
FUN_000851fa	FUN_000851fa.c
FUN_00085200	FUN_00085200.c
FUN_00085206	FUN_00085206.c
FUN_0008520c	FUN_0008520c.c
FUN_00085214	FUN_00085214.c
FUN_0008523e	FUN_0008523e.c
FUN_000852ba	FUN_000852ba.c
FUN_000852e6	FUN_000852e6.c
FUN_000852fe	FUN_000852fe.c
FUN_00085316	FUN_00085316.c
FUN_00085378	FUN_00085378.c
FUN_0008539a	FUN_0008539a.c
FUN_00085406	FUN_00085406.c
FUN_00085442	FUN_00085442.c
FUN_00085496	FUN_00085496.c
FUN_00085508	FUN_00085508.c
FUN_0008557c	FUN_0008557c.c
FUN_000855e6	FUN_000855e6.c
FUN_00085622	FUN_00085622.c
FUN_0008567c	FUN_0008567c.c
FUN_00085734	FUN_00085734.c
FUN_000857a8	FUN_000857a8.c
FUN_000857b2	FUN_000857b2.c
FUN_000857e0	FUN_000857e0.c
FUN_0008583a	FUN_0008583a.c
FUN_00085846	FUN_00085846.c
FUN_00085898	FUN_00085898.c
FUN_000858ca	FUN_000858ca.c
FUN_000858da	FUN_000858da.c
FUN_000858ec	FUN_000858ec.c
FUN_00085900	FUN_00085900.c
FUN_00085974	FUN_00085974.c
z_spin_lock_valid	z_spin_lock_valid.c
FUN_000859b6	FUN_000859b6.c
FUN_000859c2	FUN_000859c2.c
FUN_00085a04	FUN_00085a04.c
FUN_00085a9c	FUN_00085a9c.c
FUN_00085aee	FUN_00085aee.c
FUN_00085b0c	FUN_00085b0c.c
FUN_00085be8	FUN_00085be8.c
FUN_00085bf6	FUN_00085bf6.c
FUN_00085c12	FUN_00085c12.c
FUN_00085c26	FUN_00085c26.c
FUN_00085c38	FUN_00085c38.c
FUN_00085cf2	FUN_00085cf2.c
FUN_00085d36	FUN_00085d36.c
FUN_00085d5c	FUN_00085d5c.c
FUN_00085d70	FUN_00085d70.c
FUN_00085d82	FUN_00085d82.c
FUN_00085da2	FUN_00085da2.c
FUN_00085dc4	FUN_00085dc4.c
FUN_00085dd2	FUN_00085dd2.c
FUN_00085df6	FUN_00085df6.c
FUN_00085e1a	FUN_00085e1a.c
FUN_00085ebc	FUN_00085ebc.c
FUN_00085f06	FUN_00085f06.c
FUN_00085f6c	FUN_00085f6c.c
FUN_00085f9c	FUN_00085f9c.c
FUN_00085fa2	FUN_00085fa2.c
thunk_FUN_00085df6	thunk_FUN_00085df6.c
FUN_00085fd2	FUN_00085fd2.c
FUN_00086006	FUN_00086006.c
FUN_0008603c	FUN_0008603c.c
FUN_00086064	FUN_00086064.c
thunk_FUN_00085cf2	thunk_FUN_00085cf2.c
FUN_000861ae	FUN_000861ae.c
FUN_000861c2	FUN_000861c2.c
FUN_000861d4	FUN_000861d4.c
FUN_00086208	FUN_00086208.c
FUN_0008629e	FUN_0008629e.c
FUN_000862ee	FUN_000862ee.c
FUN_0008630c	FUN_0008630c.c
FUN_00086320	FUN_00086320.c
thunk_FUN_00086320	thunk_FUN_00086320.c
FUN_00086338	FUN_00086338.c
FUN_0008633e	FUN_0008633e.c
FUN_00086344	FUN_00086344.c
FUN_0008634c	FUN_0008634c.c
FUN_00086354	FUN_00086354.c
thunk_FUN_00086354	thunk_FUN_00086354.c
FUN_00086378	FUN_00086378.c
thunk_FUN_00085cf2	thunk_FUN_00085cf2.c
FUN_00086384	FUN_00086384.c
check_driver_ready	check_driver_ready.c
initialize_zephyr_heap	initialize_zephyr_heap.c
check_privilege_level	check_privilege_level.c
FUN_00086412	FUN_00086412.c
reset_system_flags	reset_system_flags.c
initialize_system_components	initialize_system_components.c
setup_memory_pools	setup_memory_pools.c
initialize_thread_safety	initialize_thread_safety.c
setup_buffer_management	setup_buffer_management.c
init_mutex	init_mutex.c
initialize_data_structures	initialize_data_structures.c
setup_error_handling	setup_error_handling.c
initialize_debug_system	initialize_debug_system.c
setup_logging_system	setup_logging_system.c
initialize_communication	initialize_communication.c
setup_bluetooth_stack	setup_bluetooth_stack.c
initialize_ble_protocol	initialize_ble_protocol.c
setup_uart_communication	setup_uart_communication.c
initialize_serial_ports	initialize_serial_ports.c
setup_sensor_interfaces	setup_sensor_interfaces.c
initialize_accelerometer	initialize_accelerometer.c
thunk_FUN_00072e9c	thunk_FUN_00072e9c.c
setup_gyroscope	setup_gyroscope.c
initialize_magnetometer	initialize_magnetometer.c
setup_ambient_light_sensor	setup_ambient_light_sensor.c
initialize_proximity_sensor	initialize_proximity_sensor.c
setup_touch_sensor	setup_touch_sensor.c
calculate_ble_connection_timing_with_validation	calculate_ble_connection_timing_with_validation.c
initialize_display_controller	initialize_display_controller.c
setup_framebuffer	setup_framebuffer.c
initialize_graphics_engine	initialize_graphics_engine.c
setup_font_rendering	setup_font_rendering.c
initialize_bitmap_handling	initialize_bitmap_handling.c
setup_image_processing	setup_image_processing.c
initialize_audio_system	initialize_audio_system.c
setup_audio_codec	setup_audio_codec.c
initialize_microphone	initialize_microphone.c
setup_audio_processing	setup_audio_processing.c
initialize_speaker	initialize_speaker.c
setup_audio_mixing	setup_audio_mixing.c
initialize_audio_effects	initialize_audio_effects.c
setup_audio_compression	setup_audio_compression.c
initialize_audio_streaming	initialize_audio_streaming.c
setup_audio_buffers	setup_audio_buffers.c
calculate_division_with_audio_integration	calculate_division_with_audio_integration.c
initialize_power_management	initialize_power_management.c
identity_function	identity_function.c
check_high_bit_set	check_high_bit_set.c
setup_voltage_regulation	setup_voltage_regulation.c
initialize_thermal_management_with_string_parsing	initialize_thermal_management_with_string_parsing.c
process_data_buffer	process_data_buffer.c
allocate_buffer_memory	allocate_buffer_memory.c
iterate_buffers_with_callback	iterate_buffers_with_callback.c
get_buffer_status_flags	get_buffer_status_flags.c
find_character_in_string	find_character_in_string.c
memcmp_byte_arrays	memcmp_byte_arrays.c
memcpy	memcpy.c
validate_memory_bounds	validate_memory_bounds.c
copy_memory_safe	copy_memory_safe.c
fill_memory_buffer	fill_memory_buffer.c
write_byte_to_buffer_with_validation_and_mutex	write_byte_to_buffer_with_validation_and_mutex.c
write_literal_text_to_buffer	write_literal_text_to_buffer.c
format_float_with_precision	format_float_with_precision.c
format_integer_with_sign	format_integer_with_sign.c
format_data_with_padding	format_data_with_padding.c
handle_buffer_overflow_condition	handle_buffer_overflow_condition.c
process_buffer_data	process_buffer_data.c
update_buffer_state	update_buffer_state.c
process_string_with_overflow_handling	process_string_with_overflow_handling.c
strcpy_safe	strcpy_safe.c
safe_string_copy	safe_string_copy.c
compare_string_offsets	compare_string_offsets.c
safe_string_copy_with_padding	safe_string_copy_with_padding.c
safe_string_copy_with_overflow_check	safe_string_copy_with_overflow_check.c
get_string_length_bounded	get_string_length_bounded.c
strstr	strstr.c
process_buffer_overflow	process_buffer_overflow.c
format_string_with_printf	format_string_with_printf.c
process_format_string	process_format_string.c
handle_format_conversion	handle_format_conversion.c
process_format_flags	process_format_flags.c
apply_format_precision	apply_format_precision.c
calculate_format_width	calculate_format_width.c
format_numeric_value	format_numeric_value.c
process_float_formatting	process_float_formatting.c
handle_special_float_cases	handle_special_float_cases.c
format_float_exponent	format_float_exponent.c
process_float_mantissa	process_float_mantissa.c
round_float_value	round_float_value.c
normalize_float_value	normalize_float_value.c
check_float_special_values	check_float_special_values.c
process_float_overflow	process_float_overflow.c
handle_float_underflow	handle_float_underflow.c
process_float_rounding	process_float_rounding.c
format_float_digits	format_float_digits.c
process_float_format	process_float_format.c
finalize_float_format	finalize_float_format.c
